日付,A:総入園者数,B:有料入園者数,C:無料入園者数,D:Cのうち幼児,E:Cのうち小学生,F:Cのうち中学生,G:Cのうち障がい者,H:Cのうち市内６５歳以上,I:CのうちD〜H以外
2011-04-01,1905,994,911,368,239,24,32,202,46
2011-04-02,2016,1227,789,297,295,20,26,35,116
2011-04-03,1645,1100,545,245,182,30,29,41,18
2011-04-04,1952,1046,906,294,322,67,32,125,66
2011-04-05,3216,1789,1427,610,391,48,57,275,46
2011-04-06,2434,1559,875,523,81,14,32,51,174
2011-04-07,1278,874,404,207,13,4,22,127,31
2011-04-08,350,266,84,45,2,0,6,24,7
2011-04-09,4069,2614,1455,739,397,34,61,163,61
2011-04-10,5765,3667,2098,1209,436,43,77,143,190
2011-04-11,1018,737,281,152,18,2,21,75,13
2011-04-12,1043,713,330,158,20,0,26,99,27
2011-04-13,527,394,133,60,2,0,7,53,11
2011-04-14,1433,954,479,229,14,1,33,168,34
2011-04-15,1392,909,483,289,10,2,18,133,31
2011-04-16,1032,667,365,112,121,5,11,52,64
2011-04-17,1619,1160,459,193,158,15,27,33,33
2011-04-18,870,589,281,99,73,5,19,64,21
2011-04-19,1529,967,562,192,82,0,31,218,39
2011-04-20,1541,975,566,252,8,33,30,201,42
2011-04-21,578,384,194,50,35,1,16,49,43
2011-04-22,797,562,235,85,9,35,15,73,18
2011-04-23,835,545,290,77,106,12,13,24,58
2011-04-24,4954,3091,1863,873,663,54,51,164,58
2011-04-25,721,513,208,55,51,1,20,63,18
2011-04-26,1287,818,469,178,28,0,26,187,50
2011-04-27,1877,1195,682,258,23,2,32,326,41
2011-04-28,697,495,202,57,34,17,10,44,40
2011-04-29,7491,4368,3123,1331,1098,106,84,413,91
2011-04-30,16195,9417,6778,3097,2244,122,169,941,205
2011-05-01,1437,955,482,155,180,91,17,22,17
2011-05-02,829,594,235,114,28,8,18,17,50
2011-05-03,15343,9694,5649,2638,2109,148,173,401,180
2011-05-04,4085,2558,1527,622,625,79,56,88,57
2011-05-05,18782,11042,7740,3554,2710,265,258,709,244
2011-05-06,7020,4554,2466,1363,139,14,197,628,125
2011-05-07,2887,1689,1198,519,377,30,47,137,88
2011-05-08,3637,2310,1327,663,354,50,44,152,64
2011-05-09,3663,2405,1258,472,22,6,74,609,75
2011-05-10,1720,1012,708,289,96,55,29,181,58
2011-05-11,3914,2367,1547,414,44,218,138,599,134
2011-05-12,4396,2653,1743,671,41,28,142,692,169
2011-05-13,389,178,211,39,46,49,3,14,60
2011-05-14,4210,2591,1619,693,496,38,82,170,140
2011-05-15,5870,3737,2133,1062,632,73,97,170,99
2011-05-16,1682,958,724,406,12,53,20,131,102
2011-05-17,1428,836,592,271,13,93,25,117,73
2011-05-18,4019,2099,1920,858,43,374,132,327,186
2011-05-19,2600,1214,1386,546,242,219,43,127,209
2011-05-20,3277,1691,1586,976,102,126,51,166,165
2011-05-21,1601,940,661,291,223,16,28,24,79
2011-05-22,6068,3828,2240,1228,624,59,51,82,196
2011-05-23,869,607,262,117,11,4,8,48,74
2011-05-24,2213,982,1231,585,336,91,24,106,89
2011-05-25,2594,1333,1261,658,46,224,44,114,175
2011-05-26,4066,1746,2320,1556,157,116,59,231,201
2011-05-27,3941,1875,2066,1473,26,39,42,238,248
2011-05-28,3906,2381,1525,830,308,37,93,99,158
2011-05-29,3809,2270,1539,713,323,22,60,60,361
2011-05-30,3953,1904,2049,642,1031,12,64,194,106
2011-05-31,3224,1517,1707,1221,2,49,58,205,172
2011-06-01,2224,1264,960,565,25,90,42,98,140
2011-06-02,1446,681,765,395,105,34,36,73,122
2011-06-03,3506,1491,2015,1033,28,564,49,116,225
2011-06-04,3334,1775,1559,649,314,19,40,124,413
2011-06-05,8173,4808,3365,1864,819,70,117,196,299
2011-06-06,2638,1432,1206,482,402,4,45,168,105
2011-06-07,2598,1444,1154,560,206,21,47,158,162
2011-06-08,2793,1344,1449,745,44,109,55,160,336
2011-06-09,2545,1206,1339,697,155,157,16,100,214
2011-06-10,3690,1530,2160,1171,349,113,57,77,393
2011-06-11,4531,2507,2024,1196,477,20,52,96,183
2011-06-12,6051,3728,2323,1293,577,40,80,115,218
2011-06-13,1048,604,444,135,136,5,15,57,96
2011-06-14,891,391,500,166,184,26,25,27,72
2011-06-15,2657,1329,1328,704,264,4,33,124,199
2011-06-16,3273,1402,1871,909,478,21,49,181,233
2011-06-17,3914,1846,2068,782,791,46,64,150,235
2011-06-18,4415,2537,1878,1006,564,32,36,99,141
2011-06-19,7494,4821,2673,1717,557,44,70,161,124
2011-06-20,2508,1366,1142,572,222,0,33,117,198
2011-06-21,2546,1298,1248,611,199,23,38,169,208
2011-06-22,2977,1200,1777,511,671,0,29,184,382
2011-06-23,2483,676,1807,504,678,116,39,80,390
2011-06-24,1559,692,867,244,392,0,15,32,184
2011-06-25,7017,3839,3178,1831,626,27,145,143,406
2011-06-26,7742,4751,2991,1626,802,70,126,227,140
2011-06-27,2185,1151,1034,545,97,2,33,126,231
2011-06-28,2222,903,1319,543,407,0,24,108,237
2011-06-29,2537,1380,1157,377,187,159,50,168,216
2011-06-30,2934,991,1943,600,816,44,39,185,259
2011-07-01,2443,1209,1234,693,165,2,19,139,216
2011-07-02,5908,3504,2404,1230,542,74,80,269,209
2011-07-03,5850,3640,2210,1216,583,36,79,178,118
2011-07-04,380,238,142,25,4,0,28,13,72
2011-07-05,2948,1040,1908,312,1209,30,26,123,208
2011-07-06,2913,1169,1744,439,675,154,51,163,262
2011-07-07,2440,1172,1268,362,485,31,59,113,218
2011-07-08,1418,569,849,255,249,80,25,40,200
2011-07-09,4810,2934,1876,976,474,46,68,149,163
2011-07-10,4230,2753,1477,826,350,37,66,76,122
2011-07-11,2624,1200,1424,624,495,5,22,135,143
2011-07-12,2582,1063,1519,553,228,256,27,120,335
2011-07-13,1934,1190,744,287,79,28,38,168,144
2011-07-14,752,316,436,24,257,94,5,6,50
2011-07-15,3420,1456,1964,622,640,270,47,184,201
2011-07-16,1085,624,461,111,151,9,48,22,120
2011-07-17,3775,2428,1347,686,396,35,56,76,98
2011-07-18,5142,3255,1887,988,546,55,72,148,78
2011-07-19,1800,1081,719,273,167,26,28,172,53
2011-07-20,2577,1193,1384,437,573,4,34,138,198
2011-07-21,1942,1152,790,329,83,56,53,159,110
2011-07-22,2242,1333,909,528,49,2,46,154,130
2011-07-23,6374,3802,2572,1200,864,74,63,203,168
2011-07-24,5058,3014,2044,1013,594,57,83,141,156
2011-07-25,2369,1390,979,549,211,22,35,80,82
2011-07-26,3104,1518,1586,655,475,72,49,153,182
2011-07-27,2651,1282,1369,584,445,55,42,118,125
2011-07-28,2857,1416,1441,603,471,93,44,92,138
2011-07-29,2603,1255,1348,554,452,67,37,102,136
2011-07-30,6657,3959,2698,1194,989,106,82,121,206
2011-07-31,5253,3204,2049,1102,581,103,66,124,73
2011-08-01,4017,2008,2009,865,741,77,44,129,153
2011-08-02,4097,2033,2064,723,863,94,54,174,156
2011-08-03,4259,2054,2205,838,947,86,54,125,155
2011-08-04,4335,1980,2355,903,971,95,57,144,185
2011-08-05,3598,1626,1972,679,1001,75,32,102,83
2011-08-06,6376,3674,2702,995,1268,116,80,118,125
2011-08-07,4233,2403,1830,746,721,132,61,68,102
2011-08-08,2615,1443,1172,467,468,83,26,67,61
2011-08-09,3355,1700,1655,712,541,88,42,140,132
2011-08-10,2216,1138,1078,446,432,54,31,48,67
2011-08-11,2970,1593,1377,549,498,104,52,72,102
2011-08-12,6282,3528,2754,1315,939,180,70,145,105
2011-08-13,8063,4969,3094,1455,1106,213,94,141,85
2011-08-14,3708,2324,1384,570,508,133,36,76,61
2011-08-15,4014,2369,1645,769,568,101,51,82,74
2011-08-16,1078,661,417,140,142,39,20,21,55
2011-08-17,4271,2401,1870,961,518,78,60,122,131
2011-08-18,3818,2075,1743,887,448,105,46,139,118
2011-08-19,3946,2029,1917,1015,488,103,40,150,121
2011-08-20,6552,4107,2445,1058,951,108,87,118,123
2011-08-21,5950,3602,2348,1318,562,122,74,160,112
2011-08-22,2670,1580,1090,511,250,96,33,89,111
2011-08-23,1152,657,495,159,151,72,14,51,48
2011-08-24,2884,1394,1490,755,257,111,54,97,216
2011-08-25,1221,461,760,383,188,81,13,18,77
2011-08-26,3431,1442,1989,1364,248,29,25,89,234
2011-08-27,9718,6084,3634,1869,1202,77,98,190,198
2011-08-28,5319,3230,2089,1178,540,32,66,111,162
2011-08-29,2979,1375,1604,1122,219,22,30,70,141
2011-08-30,3581,1182,2399,654,1414,18,39,67,207
2011-08-31,3322,827,2495,673,1222,309,24,54,213
2011-09-01,2532,804,1728,706,673,42,22,33,252
2011-09-02,414,150,264,147,74,0,2,5,36
2011-09-03,707,473,234,104,81,2,3,20,24
2011-09-04,1321,956,365,169,110,8,16,18,44
2011-09-05,473,319,154,48,8,0,2,6,90
2011-09-06,229,175,54,8,15,3,5,8,15
2011-09-07,3224,803,2421,1172,792,68,15,23,351
2011-09-08,4510,1257,3253,1274,1265,118,30,76,490
2011-09-09,5471,1053,4418,1259,2502,47,22,44,544
2011-09-10,4284,2453,1831,868,383,31,58,92,399
2011-09-11,4411,2716,1695,995,382,43,57,137,81
2011-09-12,881,574,307,128,58,0,12,56,53
2011-09-13,4926,1044,3882,709,2735,29,18,94,297
2011-09-14,3498,1360,2138,644,885,117,53,150,289
2011-09-15,2984,991,1993,715,765,9,52,87,365
2011-09-16,3585,999,2586,1527,623,1,21,84,330
2011-09-17,1051,709,342,121,151,14,9,18,29
2011-09-18,1563,1059,504,219,163,16,16,24,66
2011-09-19,5662,3395,2267,1308,575,54,76,166,88
2011-09-20,2874,1131,1743,754,638,2,26,104,219
2011-09-21,4018,779,3239,972,1854,14,21,131,247
2011-09-22,955,468,487,194,143,3,19,50,78
2011-09-23,5247,3165,2082,1202,521,47,62,175,75
2011-09-24,6536,3699,2837,1583,753,41,56,183,221
2011-09-25,6849,3996,2853,1693,655,66,111,190,138
2011-09-26,4029,1091,2938,1356,1196,2,41,109,234
2011-09-27,3144,1122,2022,1137,435,0,35,147,268
2011-09-28,3730,1217,2513,1067,914,18,44,140,330
2011-09-29,3057,1147,1910,1225,260,6,33,170,216
2011-09-30,568,317,251,179,10,1,4,12,45
2011-10-01,1024,559,465,204,98,8,19,46,90
2011-10-02,1499,1033,466,241,127,11,20,31,36
2011-10-03,500,274,226,63,23,0,9,5,126
2011-10-04,1899,768,1131,714,168,17,19,75,138
2011-10-05,2706,857,1849,1094,344,6,15,130,260
2011-10-06,2272,486,1786,1217,133,52,35,34,315
2011-10-07,1033,482,551,210,146,0,12,53,130
2011-10-08,3807,2237,1570,801,418,24,59,149,119
2011-10-09,7873,4584,3289,1709,919,53,111,262,235
2011-10-10,1527,982,545,274,151,14,34,34,38
2011-10-11,1383,745,638,346,71,5,24,123,69
2011-10-12,797,385,412,259,25,0,8,36,84
2011-10-13,1463,770,693,346,95,21,42,109,80
2011-10-14,2028,733,1295,495,501,15,28,117,139
2011-10-15,1351,871,480,214,119,10,47,32,58
2011-10-16,1738,1120,618,367,129,13,38,25,46
2011-10-17,1280,477,803,436,221,0,11,85,50
2011-10-18,826,245,581,368,25,3,4,35,146
2011-10-19,1603,826,777,547,9,12,26,82,101
2011-10-20,1298,771,527,249,20,30,33,150,45
2011-10-21,1726,843,883,361,225,12,30,175,80
2011-10-22,1180,749,431,181,133,11,20,48,38
2011-10-23,583,372,211,48,44,13,57,1,48
2011-10-24,877,557,320,174,57,15,11,45,18
2011-10-25,232,184,48,19,5,1,6,12,5
2011-10-26,325,278,47,20,2,0,4,9,12
2011-10-27,701,475,226,59,85,2,5,49,26
2011-10-28,776,494,282,137,15,44,14,53,19
2011-10-29,2698,1672,1026,573,285,12,39,60,57
2011-10-30,2772,1752,1020,630,228,30,39,46,47
2011-10-31,1369,717,652,264,281,1,16,69,21
2011-11-01,1748,852,896,430,274,23,30,109,30
2011-11-02,1307,549,758,189,262,134,15,69,89
2011-11-03,6144,3440,2704,1688,610,32,74,176,124
2011-11-04,1596,996,600,311,136,0,31,80,42
2011-11-05,866,505,361,91,107,4,16,16,127
2011-11-06,2559,1622,937,555,239,17,29,29,68
2011-11-07,658,444,214,155,16,2,9,13,19
2011-11-08,362,186,176,59,7,87,4,5,14
2011-11-09,535,316,219,96,3,80,5,14,21
2011-11-10,885,509,376,138,113,36,12,58,19
2011-11-11,977,651,326,194,15,35,12,56,14
2011-11-12,3237,1819,1418,890,269,54,28,67,110
2011-11-13,2907,1822,1085,668,282,23,34,49,29
2011-11-14,456,302,154,53,54,1,6,14,26
2011-11-15,320,249,71,42,8,0,2,11,8
2011-11-16,479,319,160,117,0,0,6,17,20
2011-11-17,190,141,49,15,5,0,2,8,19
2011-11-18,277,188,89,37,16,0,6,17,13
2011-11-19,728,434,294,98,62,20,12,11,91
2011-11-20,1254,776,478,231,88,26,26,37,70
2011-11-21,269,227,42,15,18,0,2,1,6
2011-11-22,233,183,50,12,8,4,2,10,14
2011-11-23,1725,1051,674,307,188,55,19,41,64
2011-11-24,349,281,68,23,5,13,8,8,11
2011-11-25,329,197,132,51,10,46,4,10,11
2011-11-26,1103,709,394,181,117,27,17,19,33
2011-11-27,574,412,162,88,30,6,9,15,14
2011-11-28,570,355,215,105,47,0,8,43,12
2011-11-29,309,209,100,40,18,0,5,29,8
2011-11-30,274,98,176,122,15,0,3,2,34
2011-12-01,203,136,67,22,15,0,0,13,17
2011-12-02,285,164,121,74,21,0,2,15,9
2011-12-03,532,362,170,56,36,3,9,5,61
2011-12-04,533,387,146,65,23,1,3,5,49
2011-12-05,195,155,40,13,5,0,2,2,18
2011-12-06,213,165,48,18,5,6,1,14,4
2011-12-07,209,143,66,21,1,0,3,9,32
2011-12-08,149,121,28,17,3,0,1,6,1
2011-12-09,176,148,28,16,5,0,0,5,2
2011-12-10,703,465,238,102,50,20,14,23,29
2011-12-11,672,449,223,97,38,6,15,14,53
2011-12-12,173,127,46,25,11,0,2,5,3
2011-12-13,326,174,152,84,7,0,6,12,43
2011-12-14,262,197,65,39,4,0,4,9,9
2011-12-15,187,133,54,16,0,0,3,9,26
2011-12-16,161,124,37,13,2,0,5,4,13
2011-12-17,577,403,174,57,46,1,14,15,41
2011-12-18,752,506,246,122,43,5,16,12,48
2011-12-19,351,188,163,129,3,0,8,9,14
2011-12-20,229,192,37,17,3,0,3,7,7
2011-12-21,268,200,68,40,0,0,2,12,14
2011-12-22,250,170,80,37,18,1,7,9,8
2011-12-23,544,367,177,61,41,4,6,11,54
2011-12-24,1059,804,255,86,88,19,18,16,28
2011-12-25,1205,872,333,104,110,25,15,25,54
2011-12-26,327,231,96,17,51,5,10,2,11
2011-12-27,522,294,228,75,93,6,9,7,38
2011-12-28,550,335,215,115,54,10,9,13,14
2011-12-29,0,0,0,0,0,0,0,0,0
2011-12-30,0,0,0,0,0,0,0,0,0
2011-12-31,0,0,0,0,0,0,0,0,0
2012-01-01,3449,0,3449,359,304,57,0,203,2526
2012-01-02,3446,0,3446,476,312,65,0,153,2440
2012-01-03,3998,0,3998,650,411,56,0,139,2742
2012-01-04,1033,608,425,143,174,22,25,34,27
2012-01-05,377,194,183,47,79,14,9,16,18
2012-01-06,623,333,290,136,85,12,8,21,28
2012-01-07,1187,786,401,174,125,13,21,41,27
2012-01-08,1467,928,539,242,165,30,17,23,62
2012-01-09,1495,928,567,272,179,25,20,45,26
2012-01-10,522,303,219,90,60,13,9,17,30
2012-01-11,401,196,205,61,95,10,7,8,24
2012-01-12,373,192,181,75,49,2,8,23,24
2012-01-13,516,236,280,106,125,5,7,17,20
2012-01-14,686,403,283,110,100,7,11,24,31
2012-01-15,958,620,338,178,96,8,13,6,37
2012-01-16,356,231,125,66,24,1,12,12,10
2012-01-17,247,141,106,66,3,0,5,15,17
2012-01-18,453,346,107,68,8,0,7,11,13
2012-01-19,326,207,119,69,3,3,5,16,23
2012-01-20,421,252,169,122,9,1,5,14,18
2012-01-21,952,608,344,163,72,7,24,26,52
2012-01-22,878,576,302,136,112,3,8,13,30
2012-01-23,322,150,172,23,95,1,6,5,42
2012-01-24,217,161,56,22,14,1,1,8,10
2012-01-25,257,176,81,46,3,1,6,9,16
2012-01-26,236,172,64,31,4,2,6,10,11
2012-01-27,289,173,116,79,10,4,2,12,9
2012-01-28,570,380,190,80,59,3,11,18,19
2012-01-29,947,620,327,175,90,3,11,26,22
2012-01-30,254,189,65,36,2,0,7,10,10
2012-01-31,871,251,620,385,163,1,4,13,54
2012-02-01,530,153,377,334,1,0,3,12,27
2012-02-02,206,163,43,18,10,2,4,4,5
2012-02-03,260,197,63,31,6,0,2,9,15
2012-02-04,813,524,289,128,84,23,14,18,22
2012-02-05,1515,929,586,252,197,29,18,24,66
2012-02-06,725,468,257,127,80,2,9,12,27
2012-02-07,719,426,293,189,42,2,3,18,39
2012-02-08,1115,702,413,302,23,6,8,13,61
2012-02-09,855,525,330,239,38,1,11,14,27
2012-02-10,875,444,431,337,28,1,2,3,60
2012-02-11,2329,1438,891,494,282,9,25,39,42
2012-02-12,2073,1310,763,401,252,3,30,24,53
2012-02-13,909,501,408,323,18,2,5,10,50
2012-02-14,828,431,397,286,16,2,19,31,43
2012-02-15,527,232,295,238,1,0,2,8,46
2012-02-16,671,290,381,177,145,0,7,17,35
2012-02-17,637,336,301,218,2,0,3,31,47
2012-02-18,871,564,307,156,59,5,17,26,44
2012-02-19,1961,1332,629,300,159,11,21,83,55
2012-02-20,443,327,116,53,1,1,7,30,24
2012-02-21,334,230,104,71,10,0,4,7,12
2012-02-22,405,297,108,69,2,2,8,10,17
2012-02-23,529,230,299,110,143,1,7,11,27
2012-02-24,193,150,43,16,17,0,1,5,4
2012-02-25,707,467,240,113,72,3,8,20,24
2012-02-26,1102,708,394,212,119,8,12,14,29
2012-02-27,285,238,47,32,3,0,4,3,5
2012-02-28,325,219,106,64,10,0,4,15,13
2012-02-29,460,334,126,73,9,5,6,26,7
2012-03-01,292,214,78,47,10,0,2,18,1
2012-03-02,686,222,464,170,6,246,5,8,29
2012-03-03,713,494,219,96,76,7,6,14,20
2012-03-04,1117,728,389,214,78,6,15,15,61
2012-03-05,345,264,81,36,3,0,6,7,29
2012-03-06,256,174,82,53,9,1,1,13,5
2012-03-07,440,262,178,140,2,2,6,10,18
2012-03-08,291,162,129,99,5,0,4,8,13
2012-03-09,412,291,121,89,6,1,3,13,9
2012-03-10,1384,855,529,300,123,10,24,35,37
2012-03-11,2048,1291,757,460,164,17,28,30,58
2012-03-12,357,285,72,39,9,0,6,10,8
2012-03-13,402,289,113,86,7,1,1,3,15
2012-03-14,410,301,109,54,2,0,10,9,34
2012-03-15,394,205,189,138,7,0,7,6,31
2012-03-16,552,337,215,127,7,11,10,46,14
2012-03-17,870,526,344,169,83,20,12,18,42
2012-03-18,698,441,257,116,52,11,15,7,56
2012-03-19,441,328,113,59,28,10,7,4,5
2012-03-20,606,396,210,90,72,1,11,8,28
2012-03-21,419,271,148,85,23,2,9,20,9
2012-03-22,335,179,156,84,21,19,5,7,20
2012-03-23,576,307,269,202,23,2,4,20,18
2012-03-24,431,294,137,60,33,6,13,11,14
2012-03-25,810,537,273,123,76,20,8,14,32
2012-03-26,695,423,272,106,81,15,29,22,19
2012-03-27,945,476,469,143,207,45,12,28,34
2012-03-28,1346,674,672,313,189,32,12,31,95
2012-03-29,2112,1058,1054,510,328,36,40,97,43
2012-03-30,1247,631,616,253,228,28,19,50,38
2012-03-31,483,301,182,54,72,15,10,12,19
2012-04-01,1539,927,612,339,181,18,26,28,20
2012-04-02,699,385,314,82,144,17,23,24,24
2012-04-03,355,168,187,55,60,39,9,6,18
2012-04-04,77,45,32,9,10,1,4,1,7
2012-04-05,620,355,265,136,78,7,11,10,23
2012-04-06,271,181,90,35,25,0,6,13,11
2012-04-07,991,756,235,126,66,3,5,7,28
2012-04-08,1964,1175,789,464,180,4,29,27,85
2012-04-09,281,205,76,43,0,2,3,10,18
2012-04-10,865,561,304,233,16,1,9,37,8
2012-04-11,143,102,41,21,4,0,7,4,5
2012-04-12,816,574,242,179,13,1,12,25,12
2012-04-13,418,322,96,61,2,0,8,17,8
2012-04-14,4054,2384,1670,1064,337,16,45,121,87
2012-04-15,5178,3058,2120,1378,476,35,68,73,90
2012-04-16,706,510,196,112,33,1,14,24,12
2012-04-17,204,154,50,20,11,1,1,13,4
2012-04-18,417,289,128,84,10,1,10,8,15
2012-04-19,681,476,205,110,19,6,14,38,18
2012-04-20,961,622,339,207,18,1,15,72,26
2012-04-21,5467,3199,2268,1416,434,48,94,164,112
2012-04-22,4124,2522,1602,981,324,42,69,76,110
2012-04-23,328,255,73,33,13,6,6,9,6
2012-04-24,511,341,170,77,33,1,11,33,15
2012-04-25,2108,1325,783,540,14,2,34,162,31
2012-04-26,578,304,274,54,9,153,17,17,24
2012-04-27,1142,732,410,245,14,12,17,93,29
2012-04-28,5900,3224,2676,1412,781,79,68,242,94
2012-04-29,8734,4981,3753,1925,1257,101,98,272,100
2012-04-30,11069,6388,4681,2369,1398,139,180,429,166
2012-05-01,4134,2620,1514,1005,117,60,65,210,57
2012-05-02,5597,3486,2111,1370,123,30,96,384,108
2012-05-03,5766,3368,2398,1270,721,54,105,161,87
2012-05-04,1416,881,535,225,214,24,28,25,19
2012-05-05,5008,2984,2024,994,689,88,74,108,71
2012-05-06,10192,5801,4391,2272,1236,106,167,449,161
2012-05-07,936,658,278,149,15,1,13,80,20
2012-05-08,1618,909,709,254,22,151,32,172,78
2012-05-09,1794,931,863,257,6,262,36,233,69
2012-05-10,1704,717,987,407,135,192,44,101,108
2012-05-11,1513,764,749,361,29,140,51,71,97
2012-05-12,1106,685,421,147,140,9,21,34,70
2012-05-13,4544,2699,1845,1019,521,38,61,106,100
2012-05-14,1619,970,649,429,13,31,29,96,51
2012-05-15,1116,621,495,226,23,112,22,15,97
2012-05-16,1081,252,829,53,14,631,13,24,94
2012-05-17,2451,993,1458,457,329,401,35,78,158
2012-05-18,2005,990,1015,477,122,82,40,103,191
2012-05-19,4542,2593,1949,1179,408,63,70,107,122
2012-05-20,7177,4268,2909,1803,658,58,111,167,112
2012-05-21,1939,996,943,645,45,44,26,55,128
2012-05-22,1845,946,899,548,24,60,26,92,149
2012-05-23,1330,408,922,354,26,347,13,56,126
2012-05-24,2697,986,1711,1239,108,55,30,88,191
2012-05-25,2627,945,1682,1225,43,30,55,112,217
2012-05-26,2675,1414,1261,541,277,201,49,45,148
2012-05-27,4050,2287,1763,927,243,70,55,73,395
2012-05-28,2330,1133,1197,566,460,4,25,69,73
2012-05-29,1083,353,730,356,48,177,24,31,94
2012-05-30,1829,839,990,594,3,137,39,90,127
2012-05-31,2993,1431,1562,1166,15,86,31,101,163
2012-06-01,3467,1554,1913,1337,21,262,42,81,170
2012-06-02,4430,2535,1895,954,435,25,72,165,244
2012-06-03,5963,3455,2508,1451,608,44,106,118,181
2012-06-04,2230,1256,974,406,370,4,41,82,71
2012-06-05,1919,1034,885,532,61,42,21,71,158
2012-06-06,1169,561,608,336,104,3,9,17,139
2012-06-07,1966,725,1241,737,49,233,25,38,159
2012-06-08,3117,1435,1682,1081,234,29,24,51,263
2012-06-09,4503,2143,2360,1171,405,152,72,50,510
2012-06-10,4251,2575,1676,988,425,21,54,78,110
2012-06-11,1573,890,683,368,45,84,41,61,84
2012-06-12,1695,840,855,356,305,2,17,54,121
2012-06-13,1540,639,901,222,433,2,13,70,161
2012-06-14,2275,711,1564,545,663,9,42,48,257
2012-06-15,2248,1174,1074,354,383,10,35,108,184
2012-06-16,3707,2093,1614,891,374,61,54,86,148
2012-06-17,537,373,164,63,42,6,15,10,28
2012-06-18,1528,900,628,394,83,0,23,44,84
2012-06-19,1906,717,1189,540,328,13,23,49,236
2012-06-20,654,281,373,158,144,2,13,6,50
2012-06-21,2428,524,1904,765,805,8,15,56,255
2012-06-22,2116,700,1416,587,393,189,12,55,180
2012-06-23,3309,1671,1638,952,338,34,38,50,226
2012-06-24,4990,2998,1992,1204,458,35,81,123,91
2012-06-25,1746,1026,720,387,56,12,17,87,161
2012-06-26,3227,1236,1991,718,799,100,28,97,249
2012-06-27,1930,913,1017,456,137,34,46,187,157
2012-06-28,2466,781,1685,438,914,21,22,62,228
2012-06-29,2045,865,1180,429,379,25,16,62,269
2012-06-30,4773,2519,2254,1278,479,45,66,102,284
2012-07-01,3984,2398,1586,944,430,43,49,73,47
2012-07-02,1198,666,532,384,14,2,20,37,75
2012-07-03,1892,744,1148,426,449,0,29,73,171
2012-07-04,1202,621,581,252,129,27,21,50,102
2012-07-05,1332,394,938,397,308,3,6,29,195
2012-07-06,3106,967,2139,962,858,5,22,55,237
2012-07-07,3553,1908,1645,913,378,34,61,69,190
2012-07-08,3949,2381,1568,914,370,57,54,55,118
2012-07-09,819,451,368,207,35,4,10,30,82
2012-07-10,2380,631,1749,290,1135,76,19,66,163
2012-07-11,1475,793,682,254,17,133,27,52,199
2012-07-12,307,56,251,9,117,62,2,0,61
2012-07-13,3848,1644,2204,946,807,80,35,83,253
2012-07-14,3537,1729,1808,693,391,51,221,64,388
2012-07-15,6454,3844,2610,1538,650,52,100,145,125
2012-07-16,3573,2128,1445,716,446,52,50,107,74
2012-07-17,1280,780,500,213,130,5,17,59,76
2012-07-18,1620,726,894,289,294,26,21,93,171
2012-07-19,1497,749,748,292,210,24,23,87,112
2012-07-20,1490,699,791,509,36,26,32,63,125
2012-07-21,5676,3263,2413,1114,876,76,82,119,146
2012-07-22,3898,2335,1563,851,448,51,55,95,63
2012-07-23,1456,785,671,331,148,19,17,52,104
2012-07-24,1161,608,553,214,161,7,16,47,108
2012-07-25,1103,547,556,231,69,12,13,42,189
2012-07-26,1736,803,933,308,346,42,25,92,120
2012-07-27,1700,856,844,323,327,58,17,38,81
2012-07-28,6308,3568,2740,1185,1153,99,53,71,179
2012-07-29,3033,1776,1257,555,466,84,31,49,72
2012-07-30,1795,913,882,385,309,40,20,68,60
2012-07-31,1714,821,893,347,393,47,29,35,42
2012-08-01,1045,514,531,201,183,38,20,19,70
2012-08-02,2553,1209,1344,531,503,97,31,81,101
2012-08-03,2847,1434,1413,552,622,65,31,95,48
2012-08-04,7779,4161,3618,1623,1423,102,104,156,210
2012-08-05,2512,1402,1110,437,440,38,58,54,83
2012-08-06,2484,1252,1232,452,498,70,28,65,119
2012-08-07,3730,1880,1850,823,648,67,41,147,124
2012-08-08,3194,1596,1598,772,517,99,26,95,89
2012-08-09,3412,1765,1647,708,643,48,50,110,88
2012-08-10,1660,893,767,289,314,34,20,40,70
2012-08-11,8803,5135,3668,1480,1608,151,105,182,142
2012-08-12,4852,2844,2008,962,714,86,59,105,82
2012-08-13,2393,1517,876,287,395,83,28,37,46
2012-08-14,11318,6592,4726,2340,1520,243,156,286,181
2012-08-15,8890,5304,3586,1554,1451,140,114,211,116
2012-08-16,1210,732,478,134,187,48,22,23,64
2012-08-17,3785,2082,1703,891,437,64,58,115,138
2012-08-18,9207,5487,3720,1854,1266,141,118,162,179
2012-08-19,4465,2674,1791,926,509,102,39,59,156
2012-08-20,696,408,288,65,91,61,4,8,59
2012-08-21,1520,838,682,307,122,24,37,34,158
2012-08-22,1503,822,681,328,138,53,11,45,106
2012-08-23,1665,803,862,428,183,81,20,17,133
2012-08-24,2396,971,1425,788,366,73,21,60,117
2012-08-25,8633,5312,3321,1583,1216,103,83,172,164
2012-08-26,2989,1818,1171,617,335,58,47,52,62
2012-08-27,2149,983,1166,459,507,9,11,35,145
2012-08-28,2151,765,1386,695,474,11,42,23,141
2012-08-29,2921,951,1970,1088,552,32,22,36,240
2012-08-30,3581,677,2904,949,1434,69,10,14,428
2012-08-31,2879,1030,1849,1070,452,55,20,28,224
2012-09-01,2805,1605,1200,667,311,37,33,51,101
2012-09-02,3731,2230,1501,768,471,52,60,55,95
2012-09-03,1623,659,964,713,80,3,22,21,125
2012-09-04,2112,624,1488,470,744,0,11,30,233
2012-09-05,3443,713,2730,772,1609,2,15,29,303
2012-09-06,1834,496,1338,389,734,14,5,24,172
2012-09-07,5508,1479,4029,2385,997,3,33,68,543
2012-09-08,3930,2279,1651,983,401,22,39,79,127
2012-09-09,423,292,131,30,25,4,31,5,36
2012-09-10,667,293,374,40,238,0,2,6,88
2012-09-11,1225,528,697,273,299,0,8,10,107
2012-09-12,2679,859,1820,849,524,50,51,60,286
2012-09-13,3847,1240,2607,1161,1029,37,53,62,265
2012-09-14,2923,915,2008,1184,477,9,20,48,270
2012-09-15,3871,2099,1772,846,567,34,67,80,178
2012-09-16,4199,2622,1577,800,479,72,40,64,122
2012-09-17,4017,2436,1581,830,470,71,55,78,77
2012-09-18,1628,750,878,415,336,3,20,21,83
2012-09-19,1403,255,1148,422,473,0,16,8,229
2012-09-20,3646,659,2987,833,1702,7,17,84,344
2012-09-21,3758,892,2866,1537,801,32,40,59,397
2012-09-22,5237,2832,2405,1310,664,27,65,143,196
2012-09-23,5517,3283,2234,1234,703,27,62,118,90
2012-09-24,2440,827,1613,415,959,1,37,46,155
2012-09-25,433,262,171,53,26,24,4,10,54
2012-09-26,2203,731,1472,878,130,0,84,87,293
2012-09-27,2973,695,2278,1402,536,0,18,40,282
2012-09-28,2415,780,1635,1178,174,8,15,59,201
2012-09-29,2348,1370,978,487,307,23,31,57,73
2012-09-30,1893,1176,717,319,244,34,20,40,60
2012-10-01,1030,527,503,135,218,5,16,42,87
2012-10-02,2458,787,1671,1002,302,5,26,131,205
2012-10-03,2212,692,1520,880,330,0,13,56,241
2012-10-04,2737,697,2040,1238,355,21,67,83,276
2012-10-05,2226,561,1665,708,621,10,26,51,249
2012-10-06,2067,1187,880,418,275,32,43,54,58
2012-10-07,6620,3825,2795,1635,688,65,103,191,113
2012-10-08,6991,4014,2977,1648,809,56,95,291,78
2012-10-09,1794,921,873,512,87,34,28,97,115
2012-10-10,1618,692,926,438,202,6,24,71,185
2012-10-11,228,81,147,85,22,17,2,3,18
2012-10-12,1190,478,712,389,83,78,11,30,121
2012-10-13,2376,1276,1100,527,240,19,27,54,233
2012-10-14,4191,2505,1686,924,473,30,40,135,84
2012-10-15,1311,685,626,226,142,102,23,40,93
2012-10-16,1258,597,661,342,31,6,23,185,74
2012-10-17,1292,426,866,343,316,16,14,21,156
2012-10-18,1092,439,653,277,117,60,29,53,117
2012-10-19,1490,708,782,497,33,6,25,67,154
2012-10-20,2016,1216,800,335,256,15,38,67,89
2012-10-21,2699,1699,1000,475,281,26,57,78,83
2012-10-22,1322,788,534,215,140,3,20,100,56
2012-10-23,295,210,85,24,1,16,2,15,27
2012-10-24,481,363,118,51,10,4,7,28,18
2012-10-25,974,520,454,229,9,19,13,124,60
2012-10-26,1466,864,602,359,13,0,20,92,118
2012-10-27,4501,2543,1958,935,487,30,65,244,197
2012-10-28,907,632,275,123,80,9,16,18,29
2012-10-29,784,473,311,118,103,0,31,38,21
2012-10-30,687,390,297,136,15,31,24,70,21
2012-10-31,630,431,199,105,4,2,15,53,20
2012-11-01,976,462,514,175,252,14,15,39,19
2012-11-02,127,112,15,6,5,0,0,4,0
2012-11-03,1887,1166,721,340,221,9,24,63,64
2012-11-04,831,573,258,90,94,7,13,14,40
2012-11-05,1468,959,509,279,63,2,34,91,40
2012-11-06,352,278,74,41,11,0,4,14,4
2012-11-07,126,100,26,3,3,4,2,3,11
2012-11-08,669,449,220,123,10,0,14,50,23
2012-11-09,316,234,82,29,14,0,5,7,27
2012-11-10,2530,1515,1015,498,279,13,42,99,84
2012-11-11,4734,2799,1935,1033,552,25,53,149,123
2012-11-12,202,160,42,16,19,0,2,2,3
2012-11-13,690,510,180,88,15,3,7,54,13
2012-11-14,265,173,92,69,0,0,6,8,9
2012-11-15,423,327,96,73,4,0,1,14,4
2012-11-16,559,433,126,74,4,0,9,28,11
2012-11-17,407,219,188,31,87,13,5,7,45
2012-11-18,384,235,149,12,28,1,7,7,94
2012-11-19,320,195,125,36,58,0,3,12,16
2012-11-20,193,137,56,27,10,0,2,6,11
2012-11-21,464,246,218,169,3,0,3,17,26
2012-11-22,321,221,100,38,7,37,4,8,6
2012-11-23,904,522,382,130,155,11,13,9,64
2012-11-24,1212,826,386,173,138,16,10,20,29
2012-11-25,1458,926,532,241,161,11,31,25,63
2012-11-26,203,148,55,32,8,0,4,6,5
2012-11-27,50,25,25,0,9,0,2,2,12
2012-11-28,254,181,73,37,7,1,5,8,15
2012-11-29,264,183,81,39,18,0,2,8,14
2012-11-30,146,118,28,14,1,1,3,5,4
2012-12-01,619,429,190,60,50,8,15,11,46
2012-12-02,570,394,176,70,59,3,8,9,27
2012-12-03,502,327,175,122,26,7,3,10,7
2012-12-04,73,51,22,0,9,0,1,5,7
2012-12-05,225,108,117,68,4,1,3,6,35
2012-12-06,210,148,62,13,9,0,3,3,34
2012-12-07,195,135,60,9,6,4,5,4,32
2012-12-08,479,306,173,47,35,12,9,7,63
2012-12-09,521,346,175,59,34,3,7,10,62
2012-12-10,222,127,95,8,6,0,3,9,69
2012-12-11,123,75,48,17,10,0,3,7,11
2012-12-12,672,357,315,112,70,5,9,25,94
2012-12-13,680,460,220,84,11,0,23,84,18
2012-12-14,426,317,109,49,12,0,10,23,15
2012-12-15,1529,941,588,220,201,9,20,66,72
2012-12-16,1284,846,438,207,149,13,19,17,33
2012-12-17,605,416,189,110,10,0,14,29,26
2012-12-18,564,446,118,60,11,0,17,10,20
2012-12-19,304,217,87,42,1,0,9,21,14
2012-12-20,391,242,149,48,15,16,5,25,40
2012-12-21,453,324,129,65,9,0,7,38,10
2012-12-22,935,638,297,113,99,9,18,29,29
2012-12-23,1842,1271,571,251,154,17,21,43,85
2012-12-24,1183,839,344,146,112,17,18,16,35
2012-12-25,726,537,189,68,54,9,9,21,28
2012-12-26,438,291,147,36,64,18,4,8,17
2012-12-27,749,453,296,95,102,17,18,28,36
2012-12-28,868,486,382,175,110,18,23,24,32
2012-12-29,0,0,0,0,0,0,0,0,0
2012-12-30,0,0,0,0,0,0,0,0,0
2012-12-31,0,0,0,0,0,0,0,0,0
2013-01-01,6820,0,6820,719,620,128,0,335,5018
2013-01-02,7484,0,7484,1063,763,87,0,255,5316
2013-01-03,6812,0,6812,1009,762,86,0,258,4697
2013-01-04,1550,969,581,241,215,24,12,70,19
2013-01-05,2503,1498,1005,431,333,24,29,119,69
2013-01-06,1642,993,649,291,207,18,31,55,47
2013-01-07,832,459,373,156,134,12,11,42,18
2013-01-08,950,479,471,157,165,29,20,64,36
2013-01-09,849,439,410,146,152,19,22,45,26
2013-01-10,721,379,342,122,131,4,14,48,23
2013-01-11,984,371,613,180,293,16,14,42,68
2013-01-12,1914,1141,773,346,229,19,24,75,80
2013-01-13,3273,2065,1208,570,393,39,59,75,72
2013-01-14,2700,1588,1112,471,406,18,44,116,57
2013-01-15,529,284,245,108,86,1,14,18,18
2013-01-16,956,485,471,232,148,2,10,42,37
2013-01-17,803,443,360,116,151,0,15,54,24
2013-01-18,490,248,242,82,118,1,6,22,13
2013-01-19,1062,615,447,164,154,23,18,38,50
2013-01-20,1320,830,490,244,159,12,20,22,33
2013-01-21,460,227,233,141,17,3,15,24,33
2013-01-22,496,331,165,75,5,0,16,39,30
2013-01-23,515,342,173,106,2,3,9,40,13
2013-01-24,444,282,162,75,4,0,14,47,22
2013-01-25,221,127,94,57,4,1,4,15,13
2013-01-26,913,567,346,157,115,4,16,21,33
2013-01-27,1202,766,436,209,145,7,20,23,32
2013-01-28,422,288,134,61,7,4,11,27,24
2013-01-29,454,246,208,111,42,2,8,19,26
2013-01-30,731,149,582,353,139,1,8,16,65
2013-01-31,922,359,563,451,10,1,5,37,59
2013-02-01,514,325,189,59,9,2,8,91,20
2013-02-02,1557,967,590,272,207,13,17,56,25
2013-02-03,1514,923,591,263,198,13,29,18,70
2013-02-04,538,410,128,81,18,0,7,13,9
2013-02-05,948,0,948,300,17,0,0,21,610
2013-02-06,1811,0,1811,495,110,1,0,96,1109
2013-02-07,1432,0,1432,322,145,2,0,60,903
2013-02-08,1162,0,1162,362,84,0,0,38,678
2013-02-09,3633,0,3633,790,541,21,0,95,2186
2013-02-10,9467,0,9467,2054,1344,37,0,213,5819
2013-02-11,5830,0,5830,1315,877,25,0,164,3449
2013-02-12,933,512,421,338,29,1,2,16,35
2013-02-13,827,384,443,342,10,0,10,47,34
2013-02-14,684,282,402,325,7,1,7,32,30
2013-02-15,495,303,192,111,5,1,9,40,26
2013-02-16,981,614,367,166,117,13,19,25,27
2013-02-17,1325,823,502,252,168,4,21,31,26
2013-02-18,575,275,300,246,1,0,5,14,34
2013-02-19,365,285,80,41,11,0,7,14,7
2013-02-20,461,313,148,86,3,1,9,25,24
2013-02-21,503,377,126,83,8,2,4,11,18
2013-02-22,633,280,353,278,0,0,10,23,42
2013-02-23,1695,981,714,361,189,13,18,67,66
2013-02-24,886,569,317,148,99,15,12,12,31
2013-02-25,509,330,179,128,15,1,6,17,12
2013-02-26,768,486,282,69,152,0,17,19,25
2013-02-27,541,375,166,58,55,0,9,23,21
2013-02-28,478,255,223,176,2,0,5,22,18
2013-03-01,437,154,283,42,5,202,4,11,19
2013-03-02,542,330,212,66,48,6,13,21,58
2013-03-03,697,442,255,99,82,14,10,16,34
2013-03-04,401,292,109,39,12,6,2,21,29
2013-03-05,557,433,124,59,12,1,7,28,17
2013-03-06,310,228,82,57,1,1,3,11,9
2013-03-07,416,299,117,71,8,5,7,19,7
2013-03-08,480,348,132,86,5,0,10,20,11
2013-03-09,564,404,160,45,47,5,24,4,35
2013-03-10,480,365,115,42,33,4,5,9,22
2013-03-11,405,337,68,44,9,0,4,7,4
2013-03-12,580,387,193,137,18,0,3,12,23
2013-03-13,584,223,361,312,0,2,4,8,35
2013-03-14,470,312,158,86,13,5,8,19,27
2013-03-15,608,382,226,149,6,8,8,27,28
2013-03-16,599,429,170,71,42,11,5,15,26
2013-03-17,2700,1693,1007,605,210,58,22,63,49
2013-03-18,277,219,58,36,6,3,3,4,6
2013-03-19,984,624,360,184,91,13,12,42,18
2013-03-20,1646,959,687,324,178,24,30,47,84
2013-03-21,474,334,140,54,41,5,4,27,9
2013-03-22,1070,597,473,228,20,9,15,125,76
2013-03-23,2568,1649,919,371,288,36,47,132,45
2013-03-24,4117,2625,1492,709,487,62,47,130,57
2013-03-25,1845,1171,674,248,121,36,34,193,42
2013-03-26,2122,1203,919,326,280,38,38,192,45
2013-03-27,2982,1633,1349,450,475,39,47,252,86
2013-03-28,1994,1187,807,318,246,52,25,117,49
2013-03-29,2510,1349,1161,421,411,59,46,180,44
2013-03-30,3631,2197,1434,592,482,77,51,174,58
2013-03-31,4511,2813,1698,774,560,67,59,152,86
2013-04-01,2114,1187,927,339,283,38,43,147,77
2013-04-02,2352,1253,1099,428,357,47,48,179,40
2013-04-03,2061,1065,996,309,421,58,26,138,44
2013-04-04,2567,1259,1308,445,534,36,40,201,52
2013-04-05,2719,1381,1338,463,349,44,59,317,106
2013-04-06,3824,2594,1230,590,377,22,47,134,60
2013-04-07,393,282,111,46,25,7,10,8,15
2013-04-08,385,290,95,54,13,4,4,16,4
2013-04-09,876,567,309,146,17,1,13,110,22
2013-04-10,924,645,279,135,3,1,24,92,24
2013-04-11,933,669,264,104,11,2,18,101,28
2013-04-12,659,434,225,110,5,15,10,58,27
2013-04-13,3730,2464,1266,688,298,21,55,128,76
2013-04-14,2553,1730,823,433,166,14,37,63,110
2013-04-15,1174,805,369,162,52,7,20,98,30
2013-04-16,1330,892,438,176,22,0,32,165,43
2013-04-17,573,398,175,63,3,33,6,46,24
2013-04-18,822,565,257,80,13,0,17,87,60
2013-04-19,437,318,119,32,9,0,8,52,18
2013-04-20,3371,2095,1276,483,247,40,62,230,214
2013-04-21,7961,4831,3130,1778,635,87,120,323,187
2013-04-22,2393,1523,870,291,139,9,46,320,65
2013-04-23,4000,2331,1669,590,43,2,93,852,89
2013-04-24,1060,694,366,78,7,15,19,209,38
2013-04-25,1000,668,332,99,14,1,51,127,40
2013-04-26,1226,805,421,149,18,3,24,136,91
2013-04-27,2078,1370,708,328,196,17,15,31,121
2013-04-28,3431,2326,1105,592,296,60,42,66,49
2013-04-29,5569,3449,2120,1034,600,58,62,280,86
2013-04-30,855,637,218,71,31,5,13,83,15
2013-05-01,1915,1363,552,290,26,15,27,130,64
2013-05-02,2708,1890,818,438,50,35,32,220,43
2013-05-03,3244,2046,1198,590,358,41,52,92,65
2013-05-04,10539,6412,4127,2523,1002,98,131,253,120
2013-05-05,15053,9193,5860,3062,1847,160,186,400,205
2013-05-06,1825,1221,604,217,202,46,32,57,50
2013-05-07,1887,1196,691,243,38,84,36,243,47
2013-05-08,2362,1495,867,349,26,109,62,245,76
2013-05-09,3833,2182,1651,795,54,7,134,457,204
2013-05-10,4372,2321,2051,933,80,111,120,590,217
2013-05-11,1131,684,447,124,109,16,42,64,92
2013-05-12,7320,4292,3028,1485,871,63,121,298,190
2013-05-13,1520,878,642,229,14,130,28,155,86
2013-05-14,1842,1173,669,232,25,56,40,249,67
2013-05-15,1266,703,563,146,60,99,47,138,73
2013-05-16,2263,1087,1176,408,95,220,51,242,160
2013-05-17,5457,2868,2589,964,304,88,128,894,211
2013-05-18,11529,6428,5101,2459,1226,94,235,815,272
2013-05-19,10628,6235,4393,1970,1147,102,176,516,482
2013-05-20,1861,1094,767,389,21,45,36,192,84
2013-05-21,4695,2246,2449,1559,301,54,55,280,200
2013-05-22,1965,633,1332,256,14,760,33,118,151
2013-05-23,1635,588,1047,491,150,138,13,79,176
2013-05-24,4363,1782,2581,1278,170,447,40,283,363
2013-05-25,4552,2756,1796,823,410,133,81,151,198
2013-05-26,10267,6260,4007,2376,869,106,142,355,159
2013-05-27,4031,2321,1710,776,423,32,65,278,136
2013-05-28,3055,1569,1486,830,30,117,52,233,224
2013-05-29,2125,841,1284,612,82,255,53,86,196
2013-05-30,1311,924,387,152,8,27,22,79,99
2013-05-31,4030,1961,2069,1330,27,104,92,251,265
2013-06-01,5503,3289,2214,1282,349,170,103,187,123
2013-06-02,7494,4533,2961,1660,688,130,128,198,157
2013-06-03,3317,1666,1651,583,696,78,44,161,89
2013-06-04,2963,1497,1466,936,39,80,45,179,187
2013-06-05,2928,1594,1334,681,95,85,45,131,297
2013-06-06,2249,1140,1109,692,14,51,28,127,197
2013-06-07,5011,2586,2425,1426,206,280,43,173,297
2013-06-08,7008,4005,3003,1798,603,35,88,202,277
2013-06-09,6729,4001,2728,1513,739,50,92,139,195
2013-06-10,2457,1402,1055,585,113,8,48,139,162
2013-06-11,2744,1317,1427,772,294,11,38,136,176
2013-06-12,2739,1208,1531,416,518,39,47,152,359
2013-06-13,2861,1296,1565,804,282,14,37,138,290
2013-06-14,2034,1114,920,341,240,139,7,49,144
2013-06-15,3538,2075,1463,789,351,19,55,100,149
2013-06-16,5535,3380,2155,1231,524,38,83,144,135
2013-06-17,2061,1218,843,336,80,7,37,107,276
2013-06-18,1653,821,832,344,241,5,18,85,139
2013-06-19,2304,1002,1302,523,419,1,36,114,209
2013-06-20,3161,1131,2030,1118,373,23,24,106,386
2013-06-21,3965,1711,2254,869,861,16,43,103,362
2013-06-22,6338,3234,3104,1561,594,49,84,104,712
2013-06-23,7744,4557,3187,1619,874,85,119,228,262
2013-06-24,2596,1525,1071,670,47,6,38,139,171
2013-06-25,3586,1429,2157,862,589,144,28,170,364
2013-06-26,2080,1048,1032,408,258,38,32,114,182
2013-06-27,1273,290,983,51,779,4,13,22,114
2013-06-28,2307,1049,1258,341,507,9,42,143,216
2013-06-29,6498,3421,3077,1583,682,96,111,203,402
2013-06-30,6416,3910,2506,1461,677,71,91,124,82
2013-07-01,2024,1176,848,529,113,1,30,123,52
2013-07-02,3230,1006,2224,578,1302,2,32,96,214
2013-07-03,835,364,471,222,123,29,6,30,61
2013-07-04,1977,805,1172,313,545,25,17,64,208
2013-07-05,3614,1070,2544,1020,806,20,26,77,595
2013-07-06,3958,2151,1807,933,474,57,61,95,187
2013-07-07,4639,2630,2009,972,508,53,229,122,125
2013-07-08,1776,1071,705,517,30,5,20,53,80
2013-07-09,1536,708,828,345,226,28,24,48,157
2013-07-10,1575,674,901,121,210,175,19,183,193
2013-07-11,2093,758,1335,250,561,220,22,131,151
2013-07-12,2778,985,1793,704,485,211,30,104,259
2013-07-13,5370,2613,2757,1093,500,36,364,153,611
2013-07-14,6635,4048,2587,1387,755,99,88,156,102
2013-07-15,5143,3062,2081,1017,657,47,67,151,142
2013-07-16,1575,1018,557,299,20,1,31,83,123
2013-07-17,2013,1138,875,423,138,84,33,102,95
2013-07-18,1710,890,820,278,190,124,39,109,80
2013-07-19,4015,2082,1933,854,557,141,64,145,172
2013-07-20,8230,4697,3533,1680,1351,92,90,184,136
2013-07-21,4054,2356,1698,866,498,70,58,131,75
2013-07-22,1714,1013,701,362,186,9,25,63,56
2013-07-23,1887,963,924,454,248,13,20,100,89
2013-07-24,2225,1272,953,487,113,12,19,141,181
2013-07-25,755,418,337,121,108,10,7,35,56
2013-07-26,3236,1227,2009,587,397,775,38,76,136
2013-07-27,6480,3677,2803,1103,1108,164,77,172,179
2013-07-28,4140,2370,1770,699,737,124,44,87,79
2013-07-29,2597,1189,1408,465,631,67,38,81,126
2013-07-30,4199,1973,2226,913,894,84,39,167,129
2013-07-31,2799,1419,1380,617,494,57,36,98,78
2013-08-01,3085,1452,1633,549,679,80,55,154,116
2013-08-02,3805,1832,1973,812,734,91,49,174,113
2013-08-03,10905,6435,4470,1881,1777,231,121,273,187
2013-08-04,5834,3409,2425,1208,814,105,69,150,79
2013-08-05,4255,2188,2067,981,634,116,49,150,137
2013-08-06,3730,1881,1849,662,788,55,48,121,175
2013-08-07,3344,1699,1645,650,610,60,43,134,148
2013-08-08,3710,1861,1849,721,719,68,57,186,98
2013-08-09,1819,1003,816,303,362,32,23,46,50
2013-08-10,10636,6107,4529,1941,1880,159,121,271,157
2013-08-11,6163,3724,2439,1260,773,102,86,131,87
2013-08-12,4130,2427,1703,805,591,115,45,92,55
2013-08-13,5879,3276,2603,1249,819,171,72,212,80
2013-08-14,6366,3707,2659,1339,823,147,79,203,68
2013-08-15,13269,7937,5332,2447,1877,323,150,333,202
2013-08-16,10510,6345,4165,2004,1428,217,144,219,153
2013-08-17,7956,5009,2947,1365,1002,210,99,168,103
2013-08-18,3708,2384,1324,639,429,83,44,45,84
2013-08-19,2827,1674,1153,542,344,44,33,74,116
2013-08-20,1696,1031,665,282,129,81,24,64,85
2013-08-21,2741,1422,1319,693,99,248,31,73,175
2013-08-22,3029,1566,1463,919,142,100,28,113,161
2013-08-23,2224,1016,1208,387,538,58,22,56,147
2013-08-24,8147,5289,2858,1314,886,216,84,198,160
2013-08-25,3364,2033,1331,682,374,66,36,107,66
2013-08-26,2768,1460,1308,814,251,11,28,80,124
2013-08-27,2883,992,1891,558,1039,20,16,64,194
2013-08-28,2659,1144,1515,501,735,61,25,55,138
2013-08-29,3386,1116,2270,1316,436,72,35,133,278
2013-08-30,1028,468,560,154,161,148,4,17,76
2013-08-31,6967,4421,2546,1385,749,70,69,117,156
2013-09-01,3510,2147,1363,722,384,28,40,82,107
2013-09-02,1887,785,1102,631,226,30,39,52,124
2013-09-03,2050,784,1266,527,422,118,15,47,137
2013-09-04,1301,416,885,101,585,37,21,16,125
2013-09-05,4688,1651,3037,1347,1204,12,30,93,351
2013-09-06,5406,1427,3979,1420,2044,58,26,71,360
2013-09-07,3787,2012,1775,907,405,30,40,62,331
2013-09-08,6345,3786,2559,1467,618,56,81,189,148
2013-09-09,3756,1786,1970,1279,313,10,42,131,195
2013-09-10,4128,1608,2520,1217,770,2,56,222,253
2013-09-11,3226,1311,1915,644,775,11,45,119,321
2013-09-12,3785,1108,2677,999,1184,37,52,107,298
2013-09-13,5882,1369,4513,1500,2384,16,56,164,393
2013-09-14,3034,1853,1181,631,299,20,56,71,104
2013-09-15,1079,770,309,132,102,10,18,22,25
2013-09-16,694,484,210,79,77,16,7,8,23
2013-09-17,3194,1609,1585,915,344,9,27,114,176
2013-09-18,3986,1409,2577,1326,736,0,37,131,347
2013-09-19,2966,1062,1904,1123,295,12,43,116,315
2013-09-20,4763,1061,3702,1542,1600,27,34,112,387
2013-09-21,5496,3160,2336,1358,634,42,58,149,95
2013-09-22,14068,8486,5582,3203,1598,156,158,278,189
2013-09-23,7458,4315,3143,1601,984,78,117,247,116
2013-09-24,1862,811,1051,636,196,13,14,36,156
2013-09-25,1138,210,928,103,681,8,2,4,130
2013-09-26,2956,873,2083,1008,491,6,120,77,381
2013-09-27,4130,1023,3107,1278,1281,16,25,137,370
2013-09-28,6042,3357,2685,1460,584,30,80,230,301
2013-09-29,6632,3833,2799,1680,676,48,88,154,153
2013-09-30,902,328,574,295,106,9,10,23,131
2013-10-01,888,275,613,171,300,2,2,10,128
2013-10-02,3095,1080,2015,1283,285,0,33,128,286
2013-10-03,3033,741,2292,1042,764,9,74,120,283
2013-10-04,3079,860,2219,1138,544,26,39,113,359
2013-10-05,5570,3121,2449,1427,466,22,110,228,196
2013-10-06,6799,3829,2970,1750,702,71,100,179,168
2013-10-07,2319,1149,1170,565,283,26,23,121,152
2013-10-08,1967,1078,889,592,74,7,25,85,106
2013-10-09,1269,383,886,393,151,66,17,50,209
2013-10-10,2957,1185,1772,890,316,105,39,225,197
2013-10-11,753,133,620,239,300,1,2,4,74
2013-10-12,3565,2010,1555,755,335,39,50,116,260
2013-10-13,3246,1914,1332,629,408,74,36,78,107
2013-10-14,8527,4857,3670,2174,826,80,125,298,167
2013-10-15,1131,495,636,133,284,4,21,112,82
2013-10-16,226,104,122,17,15,16,2,32,40
2013-10-17,1124,411,713,507,9,61,10,23,103
2013-10-18,2628,1258,1370,992,64,7,21,137,149
2013-10-19,6217,3446,2771,1594,592,64,74,229,218
2013-10-20,3594,2092,1502,821,386,58,54,77,106
2013-10-21,1174,656,518,179,206,0,14,37,82
2013-10-22,1401,881,520,256,35,8,36,142,43
2013-10-23,1659,838,821,519,6,0,19,182,95
2013-10-24,1134,554,580,336,54,4,22,68,96
2013-10-25,481,379,102,32,5,45,4,6,10
2013-10-26,2198,1331,867,407,250,13,36,64,97
2013-10-27,1199,684,515,180,235,28,12,14,46
2013-10-28,1403,793,610,238,155,32,18,44,123
2013-10-29,1145,568,577,206,130,59,29,94,59
2013-10-30,737,466,271,126,4,0,18,64,59
2013-10-31,1240,683,557,267,13,5,21,161,90
2013-11-01,1399,721,678,379,180,6,26,46,41
2013-11-02,4266,2453,1813,989,444,38,69,150,123
2013-11-03,3853,2436,1417,774,409,24,43,67,100
2013-11-04,5701,3261,2440,1329,740,45,73,186,67
2013-11-05,1463,900,563,298,81,6,27,123,28
2013-11-06,927,564,363,136,153,0,11,37,26
2013-11-07,629,453,176,108,6,3,9,39,11
2013-11-08,115,72,43,25,2,0,1,1,14
2013-11-09,2883,1738,1145,623,353,17,33,60,59
2013-11-10,426,320,106,31,18,0,8,6,43
2013-11-11,513,364,149,52,34,1,7,12,43
2013-11-12,402,318,84,35,13,2,4,18,12
2013-11-13,592,457,135,83,1,0,7,15,29
2013-11-14,874,529,345,119,142,0,9,36,39
2013-11-15,287,218,69,28,11,1,11,7,11
2013-11-16,3062,1826,1236,672,341,12,51,95,65
2013-11-17,4095,2514,1581,974,333,32,42,90,110
2013-11-18,577,384,193,56,71,11,14,14,27
2013-11-19,406,304,102,58,4,0,12,19,9
2013-11-20,646,433,213,145,0,0,8,22,38
2013-11-21,421,257,164,107,4,1,10,24,18
2013-11-22,487,246,241,95,100,0,12,17,17
2013-11-23,2613,1533,1080,579,284,29,36,72,80
2013-11-24,3834,2294,1540,972,316,22,53,102,75
2013-11-25,269,183,86,56,10,0,2,4,14
2013-11-26,326,228,98,58,11,0,2,18,9
2013-11-27,396,238,158,124,1,0,6,14,13
2013-11-28,268,142,126,87,4,0,6,2,27
2013-11-29,365,228,137,91,7,1,6,13,19
2013-11-30,789,535,254,110,86,17,11,5,25
2013-12-01,1361,872,489,254,119,26,15,25,50
2013-12-02,492,322,170,113,29,4,8,3,13
2013-12-03,349,263,86,35,11,0,5,21,14
2013-12-04,427,263,164,110,3,0,11,18,22
2013-12-05,488,349,139,77,13,4,6,23,16
2013-12-06,473,281,192,139,4,1,10,17,21
2013-12-07,1571,1029,542,263,121,16,25,24,93
2013-12-08,1640,1109,531,279,149,14,14,30,45
2013-12-09,488,351,137,68,26,1,12,17,13
2013-12-10,197,125,72,12,16,1,3,25,15
2013-12-11,339,230,109,74,3,0,4,15,13
2013-12-12,393,288,105,70,4,0,3,14,14
2013-12-13,396,191,205,59,113,0,2,13,18
2013-12-14,842,542,300,160,78,12,5,18,27
2013-12-15,606,432,174,59,73,5,7,3,27
2013-12-16,186,160,26,13,2,0,0,8,3
2013-12-17,370,237,133,77,10,0,7,19,20
2013-12-18,447,293,154,92,6,0,7,23,26
2013-12-19,584,266,318,93,173,1,2,27,22
2013-12-20,314,229,85,29,14,0,4,16,22
2013-12-21,1063,704,359,184,103,11,18,17,26
2013-12-22,2042,1437,605,307,186,21,19,23,49
2013-12-23,1092,694,398,149,140,12,12,18,67
2013-12-24,828,479,349,221,63,12,5,13,35
2013-12-25,667,383,284,162,70,7,4,18,23
2013-12-26,680,440,240,107,77,6,12,17,21
2013-12-27,795,467,328,131,138,13,11,17,18
2013-12-28,599,428,171,74,59,14,6,8,10
2013-12-29,0,0,0,0,0,0,0,0,0
2013-12-30,0,0,0,0,0,0,0,0,0
2013-12-31,0,0,0,0,0,0,0,0,0
2014-01-01,5829,0,5829,594,539,71,0,471,4154
2014-01-02,5288,0,5288,586,631,56,0,236,3779
2014-01-03,9070,0,9070,1226,838,94,0,351,6561
2014-01-04,2345,1378,967,429,286,39,59,94,60
2014-01-05,1832,1098,734,363,199,17,26,58,71
2014-01-06,677,342,335,75,155,15,10,20,60
2014-01-07,769,433,336,110,122,21,11,46,26
2014-01-08,755,370,385,160,147,9,14,27,28
2014-01-09,638,291,347,82,202,3,7,26,27
2014-01-10,533,251,282,115,112,2,9,17,27
2014-01-11,946,659,287,149,109,6,4,10,9
2014-01-12,1244,846,398,191,107,7,22,18,53
2014-01-13,982,622,360,144,143,32,12,11,18
2014-01-14,668,382,286,128,79,5,16,38,20
2014-01-15,789,340,449,176,171,0,15,43,44
2014-01-16,852,477,375,114,141,4,13,46,57
2014-01-17,344,208,136,50,55,2,7,12,10
2014-01-18,1312,802,510,242,159,7,19,36,47
2014-01-19,1615,1049,566,314,136,22,21,31,42
2014-01-20,417,251,166,97,35,2,7,8,17
2014-01-21,295,220,75,41,11,2,2,12,7
2014-01-22,380,197,183,98,6,50,3,10,16
2014-01-23,359,249,110,67,6,1,1,24,11
2014-01-24,386,209,177,139,2,1,1,14,20
2014-01-25,1402,884,518,277,140,14,17,33,37
2014-01-26,1507,959,548,265,167,12,24,31,49
2014-01-27,434,279,155,97,10,1,2,11,34
2014-01-28,479,216,263,102,115,1,14,13,18
2014-01-29,702,313,389,327,1,1,7,19,34
2014-01-30,674,258,416,336,15,0,4,24,37
2014-01-31,306,175,131,39,8,2,5,12,65
2014-02-01,1297,878,419,212,141,8,14,26,18
2014-02-02,1825,1174,651,313,201,10,27,29,71
2014-02-03,522,384,138,60,42,3,6,21,6
2014-02-04,592,370,222,139,33,3,4,26,17
2014-02-05,1232,0,1232,208,33,0,0,36,955
2014-02-06,1618,0,1618,394,56,1,0,80,1087
2014-02-07,1199,0,1199,222,43,3,0,54,877
2014-02-08,6491,0,6491,1318,795,43,0,212,4123
2014-02-09,6131,0,6131,1382,795,25,0,113,3816
2014-02-10,2250,0,2250,434,141,8,0,97,1570
2014-02-11,6114,0,6114,1254,750,13,0,136,3961
2014-02-12,1019,658,361,287,10,2,10,28,24
2014-02-13,643,336,307,238,17,0,4,7,41
2014-02-14,691,346,345,256,5,0,9,37,38
2014-02-15,1235,805,430,201,116,10,15,41,47
2014-02-16,1160,787,373,204,93,4,19,16,37
2014-02-17,194,172,22,12,2,4,0,2,2
2014-02-18,228,195,33,11,9,2,1,5,5
2014-02-19,408,311,97,54,6,0,5,10,22
2014-02-20,930,389,541,279,178,0,14,13,57
2014-02-21,520,264,256,205,4,1,2,8,36
2014-02-22,1354,951,403,219,87,8,21,36,32
2014-02-23,2047,1305,742,369,209,12,54,38,60
2014-02-24,832,535,297,206,10,1,8,46,26
2014-02-25,923,585,338,99,128,0,11,67,33
2014-02-26,1184,746,438,214,9,3,16,134,62
2014-02-27,1256,677,579,328,59,0,16,142,34
2014-02-28,864,473,391,263,19,0,13,57,39
2014-03-01,3133,2011,1122,435,231,17,43,184,212
2014-03-02,3070,1814,1256,606,217,35,41,133,224
2014-03-03,504,281,223,49,6,0,3,12,153
2014-03-04,568,256,312,72,11,1,9,11,208
2014-03-05,503,200,303,53,3,3,9,6,229
2014-03-06,340,131,209,20,10,1,5,7,166
2014-03-07,563,163,400,124,1,0,1,6,268
2014-03-08,1326,656,670,172,53,29,19,32,365
2014-03-09,2233,1199,1034,450,139,27,35,45,338
2014-03-10,636,248,388,103,4,3,2,11,265
2014-03-11,617,283,334,57,16,2,2,11,246
2014-03-12,747,254,493,134,5,1,7,24,322
2014-03-13,795,249,546,105,7,17,6,25,386
2014-03-14,773,234,539,130,3,6,12,14,374
2014-03-15,1465,743,722,253,102,17,22,29,299
2014-03-16,1868,888,980,299,179,20,21,36,425
2014-03-17,1035,471,564,143,9,10,15,34,353
2014-03-18,568,148,420,148,14,3,3,9,243
2014-03-19,1030,389,641,158,7,10,13,30,423
2014-03-20,903,355,548,180,60,8,8,27,265
2014-03-21,1148,553,595,190,100,20,13,15,257
2014-03-22,1648,834,814,248,163,33,12,24,334
2014-03-23,2915,1429,1486,586,162,20,26,32,660
2014-03-24,1456,616,840,307,36,23,12,42,420
2014-03-25,1335,512,823,267,44,41,16,30,425
2014-03-26,2036,800,1236,365,255,36,23,42,515
2014-03-27,2257,806,1451,413,290,39,30,58,621
2014-03-28,2023,763,1260,362,230,45,23,65,535
2014-03-29,4003,1824,2179,843,398,67,47,61,763
2014-03-30,2078,917,1161,327,203,36,43,15,537
2014-03-31,2064,671,1393,354,245,68,20,38,668
2014-04-01,1328,660,668,302,193,37,29,51,56
2014-04-02,2374,1151,1223,661,359,28,30,114,31
2014-04-03,1540,678,862,373,349,29,22,56,33
2014-04-04,263,123,140,30,67,6,3,3,31
2014-04-05,400,257,143,50,58,12,7,6,10
2014-04-06,1684,1039,645,355,184,34,18,21,33
2014-04-07,720,487,233,161,29,11,7,20,5
2014-04-08,1107,689,418,316,12,17,14,48,11
2014-04-09,1210,764,446,330,9,1,23,65,18
2014-04-10,239,184,55,28,3,0,4,14,6
2014-04-11,363,298,65,36,3,3,6,8,9
2014-04-12,2478,1657,821,546,156,12,18,42,47
2014-04-13,4821,2989,1832,1166,371,46,60,73,116
2014-04-14,1322,837,485,316,42,2,28,80,17
2014-04-15,681,479,202,112,42,0,10,25,13
2014-04-16,651,447,204,134,9,3,15,20,23
2014-04-17,667,501,166,110,10,4,5,26,11
2014-04-18,721,482,239,119,40,0,15,32,33
2014-04-19,3524,2070,1454,842,319,75,46,97,75
2014-04-20,6501,3894,2607,1777,464,53,75,118,120
2014-04-21,1255,814,441,251,76,1,22,63,28
2014-04-22,1088,745,343,210,35,4,7,71,16
2014-04-23,1319,982,337,220,8,2,16,61,30
2014-04-24,1589,1046,543,337,7,1,22,150,26
2014-04-25,1860,1133,727,430,30,3,41,158,65
2014-04-26,7769,4301,3468,2152,752,74,96,261,133
2014-04-27,8609,5048,3561,2308,823,70,88,195,77
2014-04-28,2543,1597,946,606,105,25,26,137,47
2014-04-29,8441,4719,3722,2130,886,94,119,398,95
2014-04-30,2661,1639,1022,534,38,9,47,340,54
2014-05-01,1509,1036,473,283,25,15,27,89,34
2014-05-02,4553,2766,1787,1021,143,57,74,405,87
2014-05-03,12513,6861,5652,2952,1539,135,231,590,205
2014-05-04,20633,11751,8882,5009,2326,204,295,772,276
2014-05-05,11990,6985,5005,2475,1468,184,202,466,210
2014-05-06,9035,5200,3835,1892,1051,150,155,465,122
2014-05-07,1886,1212,674,310,25,2,40,210,87
2014-05-08,1672,995,677,281,40,46,68,141,101
2014-05-09,1585,765,820,522,4,39,48,85,122
2014-05-10,4112,2338,1774,957,332,79,68,199,139
2014-05-11,7600,4458,3142,1836,684,64,158,276,124
2014-05-12,1406,928,478,294,13,5,21,108,37
2014-05-13,627,390,237,85,23,80,10,25,14
2014-05-14,1333,760,573,231,22,93,48,118,61
2014-05-15,1598,811,787,281,134,153,20,78,121
2014-05-16,600,102,498,53,112,248,2,4,79
2014-05-17,807,333,474,53,77,65,5,13,261
2014-05-18,2166,1146,1020,255,190,35,53,32,455
2014-05-19,1985,1102,883,656,8,54,28,78,59
2014-05-20,2341,1091,1250,809,26,81,41,106,187
2014-05-21,1244,603,641,329,22,142,18,65,65
2014-05-22,2763,839,1924,1191,104,278,20,117,214
2014-05-23,3119,1253,1866,1229,150,132,26,79,250
2014-05-24,3811,2121,1690,827,487,119,46,85,126
2014-05-25,6463,3739,2724,1658,646,82,97,121,120
2014-05-26,758,437,321,179,31,12,19,26,54
2014-05-27,1669,644,1025,630,21,134,31,78,131
2014-05-28,2678,1381,1297,830,3,133,55,116,160
2014-05-29,3215,1407,1808,1246,10,164,27,116,245
2014-05-30,2314,1235,1079,722,12,42,29,106,168
2014-05-31,4139,2551,1588,1070,261,25,57,119,56
2014-06-01,5904,3495,2409,1401,659,32,87,141,89
2014-06-02,3186,1738,1448,543,667,4,40,87,107
2014-06-03,2071,908,1163,788,40,93,20,43,179
2014-06-04,1528,767,761,419,35,132,12,45,118
2014-06-05,2140,993,1147,571,27,324,25,33,167
2014-06-06,3655,1663,1992,1437,9,197,34,78,237
2014-06-07,3935,2116,1819,1062,298,19,48,57,335
2014-06-08,1460,855,605,327,131,4,22,30,91
2014-06-09,1400,778,622,368,78,1,16,61,98
2014-06-10,1676,549,1127,533,294,0,25,39,236
2014-06-11,1779,736,1043,456,138,6,9,50,384
2014-06-12,901,271,630,221,286,6,21,11,85
2014-06-13,1052,572,480,233,18,137,3,4,85
2014-06-14,2802,1422,1380,632,310,25,49,56,308
2014-06-15,1604,964,640,310,152,24,30,68,56
2014-06-16,1249,317,932,311,455,0,44,21,101
2014-06-17,1877,909,968,305,260,70,19,37,277
2014-06-18,1733,525,1208,546,331,2,39,40,250
2014-06-19,2024,547,1477,498,597,1,13,42,326
2014-06-20,3081,885,2196,679,673,381,20,56,387
2014-06-21,6201,3339,2862,1587,690,52,69,121,343
2014-06-22,6292,3735,2557,1498,648,61,92,135,123
2014-06-23,2225,1105,1120,519,200,0,23,88,290
2014-06-24,3174,1399,1775,949,216,47,39,94,430
2014-06-25,1873,861,1012,321,303,2,34,119,233
2014-06-26,2222,894,1328,438,445,8,25,77,335
2014-06-27,2712,1102,1610,547,694,14,16,61,278
2014-06-28,6213,3164,3049,1902,590,47,64,111,335
2014-06-29,5085,3070,2015,1221,510,58,65,91,70
2014-06-30,1906,980,926,454,210,1,77,49,135
2014-07-01,1817,747,1070,518,246,114,15,39,138
2014-07-02,1576,727,849,241,384,5,18,65,136
2014-07-03,1770,676,1094,262,527,35,31,58,181
2014-07-04,2902,1259,1643,944,194,6,24,164,311
2014-07-05,4141,2383,1758,1061,364,42,45,82,164
2014-07-06,4369,2461,1908,1154,428,35,79,77,135
2014-07-07,1331,802,529,282,156,0,9,36,46
2014-07-08,2985,825,2160,287,1643,9,13,45,163
2014-07-09,1571,687,884,305,199,76,17,42,245
2014-07-10,680,295,385,104,113,46,24,13,85
2014-07-11,1933,664,1269,565,434,62,12,46,150
2014-07-12,3276,1738,1538,844,251,182,37,93,131
2014-07-13,4318,2505,1813,1049,422,60,54,120,108
2014-07-14,1502,859,643,372,110,8,33,46,74
2014-07-15,1426,796,630,262,167,38,32,50,81
2014-07-16,1139,617,522,263,12,55,18,65,109
2014-07-17,2132,954,1178,437,334,152,38,44,173
2014-07-18,2075,829,1246,536,255,24,11,74,346
2014-07-19,7088,4176,2912,1451,921,81,98,111,250
2014-07-20,5087,2401,2686,1041,580,62,320,98,585
2014-07-21,5277,3110,2167,1188,645,67,74,106,87
2014-07-22,1606,896,710,279,260,17,23,88,43
2014-07-23,835,378,457,95,84,177,19,32,50
2014-07-24,1902,1027,875,369,348,18,23,48,69
2014-07-25,1419,803,616,278,147,17,40,53,81
2014-07-26,2449,1496,953,323,432,52,38,36,72
2014-07-27,1587,954,633,253,226,26,39,30,59
2014-07-28,3226,1690,1536,622,592,67,46,119,90
2014-07-29,2736,1319,1417,571,568,71,37,91,79
2014-07-30,2734,1313,1421,630,507,68,32,96,88
2014-07-31,2361,1064,1297,526,451,61,33,79,147
2014-08-01,2324,1094,1230,441,447,136,29,56,121
2014-08-02,8949,5049,3900,1793,1540,166,97,154,150
2014-08-03,3303,1912,1391,636,452,153,30,69,51
2014-08-04,2338,1244,1094,425,434,68,31,66,70
2014-08-05,484,250,234,41,116,12,2,13,50
2014-08-06,2541,1265,1276,499,526,65,20,65,101
2014-08-07,1286,658,628,201,284,27,17,32,67
2014-08-08,2694,1246,1448,542,432,280,25,79,90
2014-08-09,10950,6432,4518,2105,1669,229,136,208,171
2014-08-10,4305,2560,1745,887,582,84,50,81,61
2014-08-11,1641,1012,629,252,230,64,22,33,28
2014-08-12,4744,2533,2211,1019,742,157,58,130,105
2014-08-13,4745,2663,2082,1065,614,120,68,141,74
2014-08-14,12251,7447,4804,2259,1720,269,167,244,145
2014-08-15,11786,7059,4727,2353,1593,282,130,249,120
2014-08-16,13256,7957,5299,2475,1926,341,155,264,138
2014-08-17,5509,3149,2360,1265,656,123,75,132,109
2014-08-18,3919,2008,1911,885,556,88,76,164,142
2014-08-19,418,218,200,73,41,19,6,4,57
2014-08-20,1855,1061,794,345,176,67,27,44,135
2014-08-21,3019,1573,1446,870,146,139,32,90,169
2014-08-22,880,487,393,147,156,29,9,16,36
2014-08-23,8542,5381,3161,1508,1029,161,191,97,175
2014-08-24,4886,2910,1976,1129,507,61,61,127,91
2014-08-25,1816,1119,697,489,92,16,10,45,45
2014-08-26,3704,1420,2284,1228,630,46,47,116,217
2014-08-27,3309,1372,1937,968,637,30,35,87,180
2014-08-28,2818,1147,1671,664,545,144,38,96,184
2014-08-29,3502,1499,2003,1313,357,24,26,95,188
2014-08-30,12755,7904,4851,2427,1645,146,175,214,244
2014-08-31,5008,2935,2073,1325,450,54,59,83,102
2014-09-01,2487,1208,1279,812,293,4,19,67,84
2014-09-02,3072,1243,1829,1003,553,1,22,67,183
2014-09-03,3405,1139,2266,1057,735,16,32,140,286
2014-09-04,944,211,733,106,461,72,2,4,88
2014-09-05,3825,887,2938,1225,1266,95,10,36,306
2014-09-06,4363,2526,1837,1078,441,31,53,98,136
2014-09-07,4604,2794,1810,1107,437,37,53,98,78
2014-09-08,2882,1142,1740,668,755,1,41,101,174
2014-09-09,3641,950,2691,668,1726,0,13,79,205
2014-09-10,3708,829,2879,527,1917,22,63,42,308
2014-09-11,691,526,165,68,26,9,23,12,27
2014-09-12,2310,1126,1184,550,350,2,20,60,202
2014-09-13,4330,2404,1926,991,471,101,73,125,165
2014-09-14,11628,6624,5004,2290,1860,168,164,235,287
2014-09-15,6224,3544,2680,1428,718,86,82,243,123
2014-09-16,1641,747,894,442,285,7,17,21,122
2014-09-17,2897,687,2210,921,966,1,12,26,284
2014-09-18,1286,571,715,492,78,7,9,23,106
2014-09-19,2247,493,1754,559,913,29,18,26,209
2014-09-20,3462,2029,1433,840,275,28,74,92,124
2014-09-21,5869,3496,2373,1395,585,44,96,151,102
2014-09-22,3177,1568,1609,989,319,27,33,67,174
2014-09-23,6421,3699,2722,1613,669,57,101,182,100
2014-09-24,3560,1029,2531,973,1114,25,31,108,280
2014-09-25,3519,809,2710,1236,946,0,105,47,376
2014-09-26,3506,1139,2367,1324,671,3,24,99,246
2014-09-27,3407,1906,1501,752,369,19,41,117,203
2014-09-28,3763,2179,1584,844,390,52,53,87,158
2014-09-29,2078,1058,1020,416,420,5,30,95,54
2014-09-30,1428,399,1029,778,48,0,8,26,169
2014-10-01,1762,815,947,635,115,7,15,68,107
2014-10-02,2540,842,1698,1125,173,7,75,66,252
2014-10-03,848,181,667,200,335,5,18,13,96
2014-10-04,1065,535,530,227,98,13,19,38,135
2014-10-05,4928,2865,2063,1127,487,63,71,193,122
2014-10-06,1454,635,819,378,121,3,18,37,262
2014-10-07,1868,721,1147,699,52,15,25,104,252
2014-10-08,1852,721,1131,638,77,46,17,90,263
2014-10-09,2352,883,1469,884,199,24,40,142,180
2014-10-10,851,403,448,257,65,19,10,3,94
2014-10-11,3007,1722,1285,774,233,45,42,80,111
2014-10-12,7535,4370,3165,1901,685,79,121,258,121
2014-10-13,5202,3155,2047,1040,613,58,83,146,107
2014-10-14,243,194,49,10,10,0,2,1,26
2014-10-15,1924,853,1071,569,147,23,39,185,108
2014-10-16,1856,584,1272,818,7,44,22,88,293
2014-10-17,576,219,357,105,94,54,3,37,64
2014-10-18,4614,2586,2028,1101,485,104,48,141,149
2014-10-19,6461,3662,2799,1541,774,68,82,175,159
2014-10-20,1643,924,719,362,200,2,16,89,50
2014-10-21,615,380,235,139,52,12,6,3,23
2014-10-22,1039,488,551,332,43,4,12,32,128
2014-10-23,1307,611,696,340,163,1,20,74,98
2014-10-24,1241,714,527,348,10,2,27,83,57
2014-10-25,3702,2218,1484,849,353,35,51,111,85
2014-10-26,5512,3294,2218,1343,525,53,64,167,66
2014-10-27,527,389,138,59,47,0,11,8,13
2014-10-28,404,271,133,79,5,1,0,10,38
2014-10-29,689,348,341,206,20,39,7,17,52
2014-10-30,1121,645,476,251,6,0,22,94,103
2014-10-31,822,451,371,225,6,0,18,70,52
2014-11-01,2946,1704,1242,690,280,31,47,94,100
2014-11-02,1178,811,367,147,103,12,16,25,64
2014-11-03,693,472,221,110,64,6,11,12,18
2014-11-04,399,279,120,59,27,4,10,7,13
2014-11-05,1247,736,511,220,134,3,24,96,34
2014-11-06,890,507,383,246,10,24,25,44,34
2014-11-07,529,324,205,117,57,0,3,7,21
2014-11-08,2930,1741,1189,657,257,24,47,100,104
2014-11-09,3815,2384,1431,859,345,26,40,94,67
2014-11-10,559,408,151,66,53,0,7,6,19
2014-11-11,1106,697,409,273,20,2,18,67,29
2014-11-12,614,401,213,66,91,1,7,29,19
2014-11-13,230,168,62,26,3,13,2,12,6
2014-11-14,168,143,25,11,2,0,1,4,7
2014-11-15,587,419,168,41,70,11,6,4,36
2014-11-16,1434,965,469,267,95,12,11,31,53
2014-11-17,749,587,162,73,64,4,5,5,11
2014-11-18,316,217,99,61,12,8,1,2,15
2014-11-19,580,317,263,123,90,12,8,9,21
2014-11-20,480,313,167,105,6,9,6,25,16
2014-11-21,433,229,204,51,2,107,7,10,27
2014-11-22,899,578,321,137,41,17,17,29,80
2014-11-23,4027,2496,1531,963,317,41,45,85,80
2014-11-24,2063,1267,796,447,232,21,30,35,31
2014-11-25,488,295,193,108,58,0,1,15,11
2014-11-26,487,348,139,71,15,1,9,22,21
2014-11-27,397,261,136,97,1,0,0,28,10
2014-11-28,656,356,300,119,118,1,9,30,23
2014-11-29,1217,692,525,278,94,18,22,21,92
2014-11-30,2989,1798,1191,795,200,31,43,77,45
2014-12-01,313,233,80,45,21,0,3,5,6
2014-12-02,182,157,25,10,12,0,0,0,3
2014-12-03,230,176,54,36,3,0,3,6,6
2014-12-04,240,197,43,24,1,0,2,12,4
2014-12-05,439,247,192,58,14,91,4,12,13
2014-12-06,885,604,281,170,52,4,12,21,22
2014-12-07,621,439,182,79,35,7,12,17,32
2014-12-08,340,268,72,43,15,0,4,7,3
2014-12-09,278,199,79,47,13,0,6,3,10
2014-12-10,335,203,132,102,2,0,6,4,18
2014-12-11,174,128,46,14,6,2,2,2,20
2014-12-12,377,224,153,95,18,11,3,9,17
2014-12-13,580,391,189,116,24,8,11,8,22
2014-12-14,921,641,280,141,65,12,11,22,29
2014-12-15,222,183,39,18,1,1,1,1,17
2014-12-16,177,109,68,37,10,1,1,0,19
2014-12-17,178,143,35,15,6,2,3,2,7
2014-12-18,201,171,30,4,9,2,3,2,10
2014-12-19,299,186,113,83,8,1,0,8,13
2014-12-20,1314,809,505,213,175,23,17,16,61
2014-12-21,972,651,321,166,72,11,12,17,43
2014-12-22,326,257,69,36,15,1,4,4,9
2014-12-23,869,606,263,137,77,3,9,15,22
2014-12-24,332,250,82,37,21,5,5,2,12
2014-12-25,524,389,135,72,23,13,3,8,16
2014-12-26,473,328,145,44,62,20,4,5,10
2014-12-27,917,633,284,120,69,26,19,25,25
2014-12-28,1305,894,411,193,135,27,13,23,20
2014-12-29,3,0,3,0,0,0,0,0,3
2014-12-30,0,0,0,0,0,0,0,0,0
2014-12-31,0,0,0,0,0,0,0,0,0
2015-01-01,7510,0,7510,793,557,85,0,407,5668
2015-01-02,6771,0,6771,798,673,83,0,227,4990
2015-01-03,7469,0,7469,1057,633,71,0,336,5372
2015-01-04,2855,1728,1127,485,357,78,38,100,69
2015-01-05,1336,750,586,210,205,52,18,65,36
2015-01-06,401,243,158,33,74,22,4,10,15
2015-01-07,404,255,149,60,54,4,6,18,7
2015-01-08,326,152,174,47,73,8,1,7,38
2015-01-09,614,284,330,151,105,16,7,14,37
2015-01-10,1578,1008,570,256,175,27,24,42,46
2015-01-11,2626,1665,961,469,287,50,37,77,41
2015-01-12,1912,1218,694,350,230,26,20,29,39
2015-01-13,887,473,414,197,115,34,15,30,23
2015-01-14,1371,624,747,226,336,15,34,83,53
2015-01-15,1103,646,457,212,148,5,14,57,21
2015-01-16,890,476,414,190,125,3,13,62,21
2015-01-17,1300,876,424,151,140,35,30,18,50
2015-01-18,1044,666,378,128,150,14,23,22,41
2015-01-19,571,365,206,82,81,4,5,23,11
2015-01-20,190,143,47,14,8,0,9,11,5
2015-01-21,519,385,134,84,2,3,6,31,8
2015-01-22,320,251,69,31,5,0,6,20,7
2015-01-23,198,162,36,25,2,0,1,6,2
2015-01-24,1952,1251,701,363,194,27,18,64,35
2015-01-25,3307,2040,1267,656,404,44,36,62,65
2015-01-26,646,442,204,132,2,0,13,35,22
2015-01-27,451,245,206,111,45,2,17,12,19
2015-01-28,616,339,277,77,117,34,6,17,26
2015-01-29,1298,505,793,592,92,0,7,43,59
2015-01-30,796,376,420,295,55,1,8,20,41
2015-01-31,2168,1313,855,435,252,18,43,41,66
2015-02-01,956,558,398,165,119,5,10,16,83
2015-02-02,226,176,50,23,6,6,3,8,4
2015-02-03,430,344,86,45,17,7,3,10,4
2015-02-04,595,417,178,102,25,1,5,15,30
2015-02-05,1429,0,1429,298,114,1,0,60,956
2015-02-06,1561,0,1561,380,18,1,0,72,1090
2015-02-07,6631,0,6631,1261,838,30,0,144,4358
2015-02-08,2720,0,2720,534,248,8,0,59,1871
2015-02-09,1556,0,1556,238,110,2,0,65,1141
2015-02-10,1501,0,1501,298,44,5,0,61,1093
2015-02-11,5666,0,5666,1197,650,24,0,182,3613
2015-02-12,954,670,284,208,33,1,6,13,23
2015-02-13,1021,279,742,483,151,0,3,10,95
2015-02-14,997,680,317,122,116,16,9,14,40
2015-02-15,783,530,253,97,105,7,9,10,25
2015-02-16,412,295,117,56,28,4,1,6,22
2015-02-17,1244,569,675,469,23,1,15,33,134
2015-02-18,698,435,263,198,7,0,6,24,28
2015-02-19,992,437,555,451,8,1,3,33,59
2015-02-20,852,489,363,251,20,1,7,35,49
2015-02-21,2590,1589,1001,631,209,23,25,68,45
2015-02-22,2201,1359,842,511,193,22,20,38,58
2015-02-23,840,528,312,240,13,1,11,29,18
2015-02-24,479,355,124,59,20,1,4,10,30
2015-02-25,605,397,208,156,4,0,3,18,27
2015-02-26,730,506,224,155,2,4,5,37,21
2015-02-27,347,290,57,32,3,1,5,12,4
2015-02-28,1039,701,338,153,110,5,22,22,26
2015-03-01,1420,901,519,263,135,21,14,49,37
2015-03-02,373,274,99,67,7,3,5,7,10
2015-03-03,641,515,126,62,16,0,6,26,16
2015-03-04,428,355,73,49,1,0,2,8,13
2015-03-05,569,426,143,80,5,3,1,12,42
2015-03-06,715,443,272,194,12,0,7,46,13
2015-03-07,1164,699,465,203,147,32,14,25,44
2015-03-08,3752,2281,1471,927,291,32,54,99,68
2015-03-09,448,363,85,38,5,7,6,15,14
2015-03-10,128,108,20,8,9,0,0,1,2
2015-03-11,410,318,92,44,7,1,2,6,32
2015-03-12,423,338,85,31,6,11,3,15,19
2015-03-13,343,253,90,50,9,6,1,17,7
2015-03-14,1601,994,607,293,183,33,22,32,44
2015-03-15,2728,1678,1050,667,222,28,29,56,48
2015-03-16,898,590,308,197,16,29,10,47,9
2015-03-17,805,504,301,213,17,10,6,37,18
2015-03-18,1321,839,482,341,18,13,21,61,28
2015-03-19,1013,681,332,167,25,12,26,73,29
2015-03-20,760,463,297,145,65,18,8,44,17
2015-03-21,3860,2299,1561,930,324,47,42,111,107
2015-03-22,3398,2031,1367,734,409,33,34,68,89
2015-03-23,1016,633,383,215,83,17,15,36,17
2015-03-24,429,280,149,70,34,14,7,13,11
2015-03-25,725,437,288,150,63,16,10,20,29
2015-03-26,2164,1123,1041,534,268,46,40,98,55
2015-03-27,3259,1618,1641,872,435,61,56,145,72
2015-03-28,4544,2511,2033,1187,516,57,68,135,70
2015-03-29,5089,2922,2167,1160,657,87,61,128,74
2015-03-30,3185,1573,1612,639,598,72,68,162,73
2015-03-31,1520,726,794,287,300,77,19,58,53
2015-04-01,3571,1844,1727,542,614,62,72,355,82
2015-04-02,6507,3150,3357,1175,1060,90,135,801,96
2015-04-03,345,230,115,30,56,5,6,10,8
2015-04-04,7934,4828,3106,1467,896,87,126,412,118
2015-04-05,4486,2884,1602,776,493,62,59,134,78
2015-04-06,1865,1222,643,261,97,30,30,186,39
2015-04-07,1216,850,366,147,26,3,33,131,26
2015-04-08,1567,1047,520,216,11,2,29,221,41
2015-04-09,2063,1281,782,348,15,2,49,320,48
2015-04-10,2443,1588,855,389,31,5,51,329,50
2015-04-11,4844,3175,1669,859,398,42,85,201,84
2015-04-12,9174,5697,3477,1777,978,65,132,347,178
2015-04-13,2985,1963,1022,413,47,14,56,445,47
2015-04-14,2742,1758,984,377,21,3,68,457,58
2015-04-15,396,330,66,20,2,0,7,18,19
2015-04-16,1131,779,352,113,7,5,40,156,31
2015-04-17,671,508,163,67,8,4,16,52,16
2015-04-18,4978,3236,1742,863,393,71,82,239,94
2015-04-19,5549,3607,1942,1025,537,70,50,176,84
2015-04-20,844,603,241,52,103,1,12,50,23
2015-04-21,1250,874,376,136,14,3,29,155,39
2015-04-22,3605,2185,1420,521,32,2,91,688,86
2015-04-23,4261,2536,1725,615,38,18,125,791,138
2015-04-24,1292,816,476,172,17,15,28,206,38
2015-04-25,8586,5193,3393,1617,806,78,145,571,176
2015-04-26,11944,7265,4679,2281,1216,93,172,743,174
2015-04-27,6084,3570,2514,794,96,8,132,1366,118
2015-04-28,4836,2850,1986,554,41,16,124,1127,124
2015-04-29,13918,8069,5849,2487,1607,214,248,1094,199
2015-04-30,6033,3640,2393,813,60,6,143,1261,110
2015-05-01,6384,4025,2359,958,132,70,156,888,155
2015-05-02,13285,7786,5499,2399,1601,184,311,750,254
2015-05-03,22719,13593,9126,4620,2636,289,384,898,299
2015-05-04,11382,7189,4193,1782,1389,220,204,444,154
2015-05-05,16889,9863,7026,3485,2107,209,311,665,249
2015-05-06,11602,6922,4680,2078,1501,252,222,471,156
2015-05-07,3669,2431,1238,533,44,10,79,495,77
2015-05-08,3738,1958,1780,705,183,115,70,460,247
2015-05-09,5010,3085,1925,945,440,62,116,197,165
2015-05-10,6463,4073,2390,1161,725,59,97,255,93
2015-05-11,3118,2014,1104,584,21,18,64,345,72
2015-05-12,1379,920,459,162,45,35,29,125,63
2015-05-13,1321,714,607,178,25,207,25,115,57
2015-05-14,1974,791,1183,231,95,519,83,88,167
2015-05-15,2353,1030,1323,577,127,283,37,128,171
2015-05-16,3138,1934,1204,564,316,58,74,110,82
2015-05-17,5020,3134,1886,940,554,52,109,122,109
2015-05-18,3057,1743,1314,637,72,166,81,233,125
2015-05-19,728,396,332,43,25,155,34,28,47
2015-05-20,2055,1033,1022,337,299,87,36,139,124
2015-05-21,2111,839,1272,759,42,143,30,70,228
2015-05-22,3532,1707,1825,1257,72,42,37,147,270
2015-05-23,6582,3689,2893,1376,588,66,111,232,520
2015-05-24,7164,4366,2798,1593,617,47,99,162,280
2015-05-25,2543,1424,1119,657,37,8,46,242,129
2015-05-26,2557,1138,1419,935,23,99,39,133,190
2015-05-27,2905,1500,1405,739,8,156,69,248,185
2015-05-28,3411,1354,2057,1308,6,246,37,188,272
2015-05-29,2727,1311,1416,692,16,260,64,203,181
2015-05-30,4440,2796,1644,983,259,23,89,188,102
2015-05-31,4343,2765,1578,755,499,53,73,122,76
2015-06-01,4359,2026,2333,822,1045,34,70,191,171
2015-06-02,2486,1277,1209,795,29,64,35,130,156
2015-06-03,1644,837,807,336,18,172,31,110,140
2015-06-04,1885,776,1109,742,11,158,18,31,149
2015-06-05,1136,555,581,337,74,85,8,20,57
2015-06-06,4595,2461,2134,943,373,160,73,111,474
2015-06-07,6188,3583,2605,1331,662,33,93,155,331
2015-06-08,2353,1341,1012,424,306,5,37,134,106
2015-06-09,1011,510,501,289,104,3,13,9,83
2015-06-10,1532,752,780,202,161,24,33,157,203
2015-06-11,2485,1063,1422,724,264,15,44,110,265
2015-06-12,4687,1939,2748,1095,696,401,45,144,367
2015-06-13,2510,1516,994,498,293,10,27,75,91
2015-06-14,5764,3439,2325,1308,611,77,93,151,85
2015-06-15,2483,1379,1104,559,178,5,33,140,189
2015-06-16,3549,1612,1937,976,350,12,59,190,350
2015-06-17,2714,1268,1446,782,251,6,37,120,250
2015-06-18,2371,1137,1234,534,254,3,50,164,229
2015-06-19,3656,1800,1856,948,397,2,45,117,347
2015-06-20,7528,4073,3455,1880,743,112,100,159,461
2015-06-21,6067,3747,2320,1328,552,47,95,194,104
2015-06-22,2087,1197,890,453,56,70,37,139,135
2015-06-23,2327,921,1406,552,513,14,14,71,242
2015-06-24,2469,1324,1145,197,481,8,45,115,299
2015-06-25,2397,1005,1392,428,443,67,38,109,307
2015-06-26,2661,1187,1474,478,510,12,63,131,280
2015-06-27,4861,2609,2252,1331,412,23,47,120,319
2015-06-28,2716,1761,955,447,277,46,30,75,80
2015-06-29,1743,1058,685,402,55,1,48,79,100
2015-06-30,1022,367,655,148,405,1,5,38,58
2015-07-01,630,346,284,43,145,0,16,34,46
2015-07-02,1478,567,911,121,639,9,13,34,95
2015-07-03,2980,1203,1777,817,499,39,37,93,292
2015-07-04,3603,2038,1565,857,408,42,47,87,124
2015-07-05,5758,3483,2275,1378,544,37,64,154,98
2015-07-06,2224,1278,946,579,119,7,31,121,89
2015-07-07,1085,479,606,139,303,66,8,31,59
2015-07-08,2206,1024,1182,427,271,13,29,129,313
2015-07-09,2290,1036,1254,333,278,241,74,181,147
2015-07-10,3732,1062,2670,582,1675,4,37,119,253
2015-07-11,4298,2448,1850,959,373,101,83,108,226
2015-07-12,4264,2625,1639,887,360,46,104,105,137
2015-07-13,932,522,410,102,214,3,8,31,52
2015-07-14,1393,660,733,202,302,28,23,52,126
2015-07-15,1966,1093,873,361,22,236,26,119,109
2015-07-16,1772,962,810,314,15,198,35,135,113
2015-07-17,2808,1348,1460,573,553,3,19,129,183
2015-07-18,2742,1652,1090,548,213,23,34,87,185
2015-07-19,3594,2263,1331,695,361,58,47,103,67
2015-07-20,4636,2746,1890,947,561,76,62,180,64
2015-07-21,1431,754,677,240,239,25,23,86,64
2015-07-22,956,469,487,170,197,6,6,35,73
2015-07-23,1299,744,555,279,81,16,16,59,104
2015-07-24,1795,964,831,380,168,23,37,123,100
2015-07-25,3065,1271,1794,461,370,47,321,51,544
2015-07-26,2518,1481,1037,451,370,41,48,66,61
2015-07-27,2857,1528,1329,539,494,108,38,71,79
2015-07-28,2639,1340,1299,550,447,64,49,84,105
2015-07-29,2890,1424,1466,524,561,74,44,116,147
2015-07-30,2732,1299,1433,526,464,125,35,88,195
2015-07-31,2053,970,1083,394,397,63,33,74,122
2015-08-01,9311,5393,3918,1640,1678,150,124,184,142
2015-08-02,4584,2668,1916,885,692,104,59,114,62
2015-08-03,2844,1532,1312,441,560,64,29,123,95
2015-08-04,3033,1501,1532,611,636,52,46,109,78
2015-08-05,2066,1033,1033,363,445,35,47,51,92
2015-08-06,1899,1046,853,307,348,68,28,55,47
2015-08-07,2996,1524,1472,645,544,74,40,91,78
2015-08-08,10298,5812,4486,1943,1881,179,109,221,153
2015-08-09,5567,3210,2357,1151,735,130,85,130,126
2015-08-10,3416,1903,1513,614,614,62,38,111,74
2015-08-11,2222,1259,963,385,362,56,30,57,73
2015-08-12,3139,1805,1334,634,448,76,27,90,59
2015-08-13,9665,5626,4039,1904,1352,249,146,239,149
2015-08-14,10635,6444,4191,1890,1574,237,123,224,143
2015-08-15,9822,6092,3730,1660,1344,258,121,212,135
2015-08-16,4830,2848,1982,912,656,108,85,128,93
2015-08-17,4565,2449,2116,995,672,101,52,189,107
2015-08-18,905,493,412,142,130,24,11,20,85
2015-08-19,2642,1520,1122,565,223,70,35,116,113
2015-08-20,2553,1350,1203,534,203,156,24,189,97
2015-08-21,2669,1539,1130,653,183,55,27,128,84
2015-08-22,11289,6940,4349,2092,1490,194,164,225,184
2015-08-23,5149,3080,2069,1189,499,45,71,160,105
2015-08-24,2780,1418,1362,879,186,19,30,133,115
2015-08-25,3149,1355,1794,1018,406,21,38,117,194
2015-08-26,2789,1364,1425,720,355,47,19,98,186
2015-08-27,1640,523,1117,86,753,60,16,25,177
2015-08-28,2999,1284,1715,704,644,95,25,100,147
2015-08-29,9825,6024,3801,1887,1289,110,113,212,190
2015-08-30,4702,2799,1903,1128,505,36,57,97,80
2015-08-31,2199,1105,1094,610,270,0,33,61,120
2015-09-01,2899,1132,1767,1265,96,0,46,131,229
2015-09-02,1041,213,828,232,413,8,1,56,118
2015-09-03,2964,1021,1943,777,862,18,17,43,226
2015-09-04,2237,629,1608,741,619,2,0,10,236
2015-09-05,7673,4810,2863,1496,754,60,107,135,311
2015-09-06,4261,2582,1679,996,369,26,60,94,134
2015-09-07,3112,1190,1922,1279,188,46,31,122,256
2015-09-08,3868,1363,2505,620,1400,0,27,161,297
2015-09-09,3837,1062,2775,792,1488,1,36,81,377
2015-09-10,2379,849,1530,601,451,25,52,36,365
2015-09-11,3287,656,2631,673,1313,296,16,42,291
2015-09-12,6851,3623,3228,1216,603,63,72,93,1181
2015-09-13,795,549,246,53,77,13,14,21,68
2015-09-14,1555,672,883,493,196,0,19,54,121
2015-09-15,2454,578,1876,770,822,0,17,57,210
2015-09-16,2769,773,1996,732,918,11,21,93,221
2015-09-17,2733,524,2209,1055,814,0,31,56,253
2015-09-18,3531,764,2767,1144,1239,41,27,19,297
2015-09-19,3754,2366,1388,475,628,69,43,62,111
2015-09-20,4565,2774,1791,929,573,49,55,80,105
2015-09-21,7098,4211,2887,1591,793,71,112,207,113
2015-09-22,8808,4992,3816,2088,1024,117,134,329,124
2015-09-23,6563,3709,2854,1478,845,82,89,261,99
2015-09-24,2202,1029,1173,593,270,30,25,78,177
2015-09-25,4047,1194,2853,1571,825,3,47,71,336
2015-09-26,3182,1775,1407,695,341,33,60,84,194
2015-09-27,2622,1562,1060,540,316,28,33,80,63
2015-09-28,1239,443,796,217,413,80,8,14,64
2015-09-29,1909,412,1497,777,462,1,19,10,228
2015-09-30,1723,697,1026,712,13,17,26,88,170
2015-10-01,2155,650,1505,933,277,18,11,78,188
2015-10-02,564,273,291,38,190,0,14,8,41
2015-10-03,2969,1603,1366,784,316,19,51,65,131
2015-10-04,3014,1749,1265,671,289,34,38,89,144
2015-10-05,1808,771,1037,401,374,3,18,41,200
2015-10-06,3327,1335,1992,1180,352,13,27,149,271
2015-10-07,2990,1048,1942,1231,183,38,31,143,316
2015-10-08,270,115,155,4,37,26,1,1,86
2015-10-09,635,250,385,275,13,15,9,6,67
2015-10-10,4361,2572,1789,1098,443,35,43,100,70
2015-10-11,2262,1274,988,346,364,78,28,35,137
2015-10-12,3364,2033,1331,728,384,32,41,72,74
2015-10-13,905,404,501,346,84,0,11,14,46
2015-10-14,1315,561,754,423,53,58,16,35,169
2015-10-15,1830,686,1144,666,107,18,37,147,169
2015-10-16,3325,929,2396,1205,623,61,44,162,301
2015-10-17,5803,3269,2534,1499,552,28,91,245,119
2015-10-18,4836,2823,2013,1189,491,26,57,154,96
2015-10-19,1435,909,526,254,136,4,24,80,28
2015-10-20,368,215,153,38,56,12,5,8,34
2015-10-21,1426,830,596,340,21,25,18,85,107
2015-10-22,1226,685,541,303,10,33,14,98,83
2015-10-23,1668,844,824,311,129,106,31,147,100
2015-10-24,1527,922,605,183,211,32,28,55,96
2015-10-25,726,525,201,74,65,6,12,4,40
2015-10-26,1310,873,437,240,90,2,19,47,39
2015-10-27,879,556,323,203,19,2,12,59,28
2015-10-28,751,558,193,121,7,0,8,46,11
2015-10-29,621,435,186,121,5,5,8,23,24
2015-10-30,893,460,433,148,97,70,14,36,68
2015-10-31,1840,1046,794,290,257,24,36,59,128
2015-11-01,5563,3225,2338,1268,679,44,67,200,80
2015-11-02,2487,1451,1036,609,236,3,29,126,33
2015-11-03,7230,3984,3246,1778,911,41,100,277,139
2015-11-04,1736,962,774,354,147,1,20,217,35
2015-11-05,2089,1204,885,454,157,0,25,203,46
2015-11-06,1222,749,473,272,129,10,8,35,19
2015-11-07,2551,1552,999,486,345,12,23,62,71
2015-11-08,1361,880,481,194,175,10,22,24,56
2015-11-09,961,684,277,141,65,1,7,46,17
2015-11-10,210,180,30,9,5,0,2,9,5
2015-11-11,532,391,141,62,14,2,15,25,23
2015-11-12,859,604,255,151,4,14,7,53,26
2015-11-13,906,581,325,160,14,5,17,100,29
2015-11-14,1600,1059,541,282,160,10,21,44,24
2015-11-15,1078,731,347,133,124,21,19,15,35
2015-11-16,1799,1008,791,332,307,11,30,79,32
2015-11-17,545,395,150,91,11,0,13,24,11
2015-11-18,669,466,203,127,12,14,6,29,15
2015-11-19,608,429,179,86,8,30,12,31,12
2015-11-20,460,353,107,62,4,11,9,15,6
2015-11-21,1578,979,599,299,193,24,19,18,46
2015-11-22,3793,2361,1432,805,413,39,44,66,65
2015-11-23,3359,1979,1380,758,422,44,43,70,43
2015-11-24,178,125,53,11,19,0,3,11,9
2015-11-25,264,157,107,60,3,0,1,6,37
2015-11-26,273,211,62,41,4,0,1,6,10
2015-11-27,281,210,71,33,12,0,3,4,19
2015-11-28,744,505,239,89,66,7,15,12,50
2015-11-29,1419,922,497,285,115,13,24,20,40
2015-11-30,373,251,122,56,40,0,4,14,8
2015-12-01,294,226,68,35,13,1,2,6,11
2015-12-02,486,355,131,80,13,3,5,16,14
2015-12-03,252,187,65,45,8,0,0,3,9
2015-12-04,506,318,188,70,77,1,3,12,25
2015-12-05,955,657,298,139,79,10,3,18,49
2015-12-06,1826,1257,569,273,170,31,24,41,30
2015-12-07,439,346,93,43,22,3,6,13,6
2015-12-08,502,414,88,45,16,2,3,16,6
2015-12-09,522,358,164,80,19,6,8,28,23
2015-12-10,544,405,139,54,24,2,12,15,32
2015-12-11,423,309,114,57,27,4,1,4,21
2015-12-12,1731,1054,677,372,146,37,22,41,59
2015-12-13,2249,1398,851,482,227,15,36,37,54
2015-12-14,1032,704,328,229,27,5,9,34,24
2015-12-15,458,342,116,53,20,4,6,9,24
2015-12-16,421,283,138,80,15,3,4,26,10
2015-12-17,301,233,68,13,11,0,4,13,27
2015-12-18,326,266,60,26,15,2,2,12,3
2015-12-19,677,479,198,50,53,17,10,11,57
2015-12-20,1384,931,453,225,116,22,15,37,38
2015-12-21,436,329,107,59,24,4,4,11,5
2015-12-22,552,417,135,57,28,2,6,19,23
2015-12-23,1475,961,514,276,125,13,14,41,45
2015-12-24,863,618,245,125,51,8,10,27,24
2015-12-25,388,285,103,38,31,9,6,10,9
2015-12-26,863,627,236,84,97,10,11,19,15
2015-12-27,1449,960,489,233,171,21,15,12,37
2015-12-28,1176,851,325,130,130,17,11,14,23
2015-12-29,0,0,0,0,0,0,0,0,0
2015-12-30,0,0,0,0,0,0,0,0,0
2015-12-31,0,0,0,0,0,0,0,0,0
2016-01-01,6179,0,6179,607,447,61,0,329,4735
2016-01-02,6005,0,6005,780,570,80,0,366,4209
2016-01-03,7562,0,7562,1080,657,87,0,423,5315
2016-01-04,1485,940,545,272,154,23,18,57,21
2016-01-05,1125,678,447,189,168,22,13,33,22
2016-01-06,1090,623,467,186,141,22,23,43,52
2016-01-07,829,491,338,135,95,24,20,35,29
2016-01-08,788,384,404,145,149,23,8,23,56
2016-01-09,1813,1142,671,335,181,13,23,63,56
2016-01-10,2248,1430,818,418,253,23,30,48,46
2016-01-11,1904,1216,688,353,206,32,22,42,33
2016-01-12,667,303,364,138,153,16,15,19,23
2016-01-13,820,476,344,102,165,11,6,27,33
2016-01-14,899,444,455,199,144,14,22,32,44
2016-01-15,553,359,194,73,71,0,3,25,22
2016-01-16,1556,1126,430,227,112,9,17,35,30
2016-01-17,1826,1152,674,340,191,13,27,53,50
2016-01-18,596,323,273,98,95,11,12,32,25
2016-01-19,444,326,118,33,49,0,8,8,20
2016-01-20,564,324,240,171,21,0,7,11,30
2016-01-21,335,245,90,42,12,1,2,12,21
2016-01-22,533,259,274,67,141,1,4,11,50
2016-01-23,1433,959,474,233,119,10,32,33,47
2016-01-24,1814,1137,677,371,202,16,16,40,32
2016-01-25,484,319,165,106,22,3,4,7,23
2016-01-26,444,354,90,46,17,0,4,18,5
2016-01-27,504,365,139,83,12,1,5,14,24
2016-01-28,928,328,600,513,21,2,2,12,50
2016-01-29,715,325,390,265,16,42,22,24,21
2016-01-30,1241,812,429,229,136,15,13,18,18
2016-01-31,1713,1055,658,354,179,9,24,32,60
2016-02-01,595,353,242,150,13,5,5,18,51
2016-02-02,896,637,259,167,32,4,5,26,25
2016-02-03,576,455,121,47,16,0,9,36,13
2016-02-04,768,584,184,98,27,5,13,18,23
2016-02-05,775,487,288,199,27,3,4,19,36
2016-02-06,3913,0,3913,639,496,28,0,121,2629
2016-02-07,4985,0,4985,1017,591,25,0,144,3208
2016-02-08,1080,751,329,205,36,4,13,23,48
2016-02-09,1003,724,279,199,24,2,5,22,27
2016-02-10,793,413,380,188,135,5,2,5,45
2016-02-11,2940,1821,1119,609,342,13,43,56,56
2016-02-12,1315,898,417,281,34,6,14,42,40
2016-02-13,1587,1154,433,210,144,12,15,19,33
2016-02-14,850,635,215,91,68,13,7,15,21
2016-02-15,623,399,224,185,10,2,4,9,14
2016-02-16,919,453,466,313,54,0,8,25,66
2016-02-17,724,412,312,240,8,0,5,20,39
2016-02-18,1061,426,635,523,8,3,6,32,63
2016-02-19,725,468,257,189,15,0,3,26,24
2016-02-20,1958,1202,756,420,184,17,27,40,68
2016-02-21,1328,853,475,239,122,20,17,25,52
2016-02-22,752,474,278,201,9,0,7,26,35
2016-02-23,412,335,77,36,12,1,1,12,15
2016-02-24,353,297,56,38,2,0,3,8,5
2016-02-25,580,452,128,89,4,4,4,18,9
2016-02-26,482,403,79,28,15,1,6,18,11
2016-02-27,1465,972,493,277,115,4,16,43,38
2016-02-28,2212,1415,797,444,206,17,31,47,52
2016-02-29,351,312,39,20,5,0,3,5,6
2016-03-01,299,267,32,14,1,1,0,0,16
2016-03-02,523,422,101,61,5,1,7,14,13
2016-03-03,461,406,55,26,7,4,5,8,5
2016-03-04,543,426,117,71,4,6,7,22,7
2016-03-05,2361,1490,871,497,230,18,21,60,45
2016-03-06,707,496,211,106,46,7,7,12,33
2016-03-07,995,631,364,287,5,1,15,30,26
2016-03-08,758,608,150,80,8,1,16,30,15
2016-03-09,754,555,199,140,7,1,3,27,21
2016-03-10,547,429,118,58,5,0,11,17,27
2016-03-11,618,456,162,107,7,1,10,26,11
2016-03-12,1578,1021,557,295,150,28,10,42,32
2016-03-13,2779,1707,1072,604,282,56,36,47,47
2016-03-14,961,726,235,126,19,13,14,27,36
2016-03-15,936,765,171,83,21,9,7,33,18
2016-03-16,1518,1042,476,292,15,15,24,100,30
2016-03-17,1769,1100,669,433,23,32,24,123,34
2016-03-18,1395,841,554,310,95,25,26,71,27
2016-03-19,1141,753,388,199,119,4,18,23,25
2016-03-20,3539,2140,1399,700,478,58,42,66,55
2016-03-21,2631,1618,1013,479,296,68,49,49,72
2016-03-22,1314,818,496,306,73,36,8,49,24
2016-03-23,773,558,215,118,42,7,6,23,19
2016-03-24,877,547,330,189,31,39,11,22,38
2016-03-25,689,463,226,104,52,31,4,11,24
2016-03-26,2241,1344,897,455,231,51,26,46,88
2016-03-27,5580,3326,2254,1424,545,57,55,109,64
2016-03-28,2647,1602,1045,474,339,84,25,88,35
2016-03-29,3297,1673,1624,766,515,80,49,140,74
2016-03-30,912,482,430,127,191,32,14,27,39
2016-03-31,2426,1205,1221,524,433,77,36,115,36
2016-04-01,2300,1226,1074,489,352,54,23,133,23
2016-04-02,3305,1907,1398,801,391,45,38,79,44
2016-04-03,1639,1043,596,290,183,32,20,32,39
2016-04-04,2637,1311,1326,607,460,65,38,110,46
2016-04-05,2619,1401,1218,654,324,55,32,134,19
2016-04-06,1639,983,656,449,53,16,28,88,22
2016-04-07,765,517,248,160,10,6,13,33,26
2016-04-08,636,447,189,108,7,0,11,38,25
2016-04-09,2033,1308,725,439,190,13,27,31,25
2016-04-10,3773,2288,1485,837,372,39,49,86,102
2016-04-11,0,0,0,0,0,0,0,0,0
2016-04-12,0,0,0,0,0,0,0,0,0
2016-04-13,0,0,0,0,0,0,0,0,0
2016-04-14,0,0,0,0,0,0,0,0,0
2016-04-15,0,0,0,0,0,0,0,0,0
2016-04-16,3521,2116,1405,869,294,17,45,107,73
2016-04-17,1054,716,338,137,86,17,22,14,62
2016-04-18,910,625,285,108,93,5,9,29,41
2016-04-19,423,307,116,44,18,16,6,17,15
2016-04-20,1685,1058,627,430,24,0,21,116,36
2016-04-21,2019,1294,725,452,29,3,42,161,38
2016-04-22,1834,1187,647,386,50,1,26,162,22
2016-04-23,1299,884,415,165,100,33,38,12,67
2016-04-24,7596,4538,3058,2026,634,77,74,148,99
2016-04-25,1590,1096,494,271,42,3,20,140,18
2016-04-26,1158,748,410,203,14,0,23,110,60
2016-04-27,0,0,0,0,0,0,0,0,0
2016-04-28,1631,973,658,258,30,44,37,203,86
2016-04-29,881,599,282,109,73,33,12,31,24
2016-04-30,1678,1044,634,303,148,31,45,69,38
2016-05-01,8136,4987,3149,1752,707,103,122,317,148
2016-05-02,7583,4708,2875,1774,216,15,117,632,121
2016-05-03,20167,11398,8769,4864,1942,195,301,1157,310
2016-05-04,5389,3226,2163,1430,393,65,70,128,77
2016-05-05,12045,6719,5326,3554,1035,115,145,349,128
2016-05-06,2949,1820,1129,621,79,26,70,255,78
2016-05-07,2296,1480,816,424,187,26,44,48,87
2016-05-08,7153,4200,2953,1761,699,77,99,221,96
2016-05-09,1730,1039,691,364,25,6,42,205,49
2016-05-10,1646,946,700,369,28,34,66,69,134
2016-05-11,0,0,0,0,0,0,0,0,0
2016-05-12,1286,566,720,135,68,189,98,44,186
2016-05-13,2835,1523,1312,700,48,222,36,163,143
2016-05-14,6737,3663,3074,1848,598,106,124,218,180
2016-05-15,5866,3440,2426,1422,579,87,91,127,120
2016-05-16,679,334,345,126,16,130,4,30,39
2016-05-17,1781,1030,751,400,76,16,44,106,109
2016-05-18,1959,1117,842,433,63,115,27,122,82
2016-05-19,2610,1017,1593,760,54,375,26,125,253
2016-05-20,3206,1287,1919,1197,63,235,36,105,283
2016-05-21,5689,3094,2595,1391,475,81,99,136,413
2016-05-22,6411,3757,2654,1421,578,66,96,151,342
2016-05-23,2039,1131,908,647,13,4,25,107,112
2016-05-24,2381,1110,1271,998,20,2,24,96,131
2016-05-25,0,0,0,0,0,0,0,0,0
2016-05-26,2201,899,1302,717,24,259,28,88,186
2016-05-27,2554,939,1615,1118,18,84,15,140,240
2016-05-28,4860,2919,1941,1328,232,31,77,187,86
2016-05-29,6266,3551,2715,1471,507,41,86,193,417
2016-05-30,2580,1210,1370,327,708,26,50,179,80
2016-05-31,983,351,632,216,9,265,16,48,78
2016-06-01,491,260,231,49,0,101,9,28,44
2016-06-02,1889,1021,868,593,9,60,23,74,109
2016-06-03,2630,979,1651,926,16,405,28,59,217
2016-06-04,1527,741,786,188,77,107,25,47,342
2016-06-05,4686,2779,1907,1173,341,25,98,175,95
2016-06-06,2351,1252,1099,495,259,34,39,178,94
2016-06-07,2145,1108,1037,528,105,61,32,168,143
2016-06-08,0,0,0,0,0,0,0,0,0
2016-06-09,1396,406,990,357,158,306,5,48,116
2016-06-10,2946,1165,1781,806,383,163,34,49,346
2016-06-11,5184,2867,2317,1294,497,42,70,140,274
2016-06-12,4968,2910,2058,1188,559,18,59,104,130
2016-06-13,415,265,150,20,89,1,6,0,34
2016-06-14,1264,526,738,448,132,12,13,24,109
2016-06-15,3094,1425,1669,794,397,0,22,116,340
2016-06-16,1445,547,898,466,242,2,13,20,155
2016-06-17,1034,543,491,142,284,2,4,3,56
2016-06-18,4572,2367,2205,1273,423,39,42,63,365
2016-06-19,5761,3412,2349,1456,521,32,97,142,101
2016-06-20,377,186,191,30,34,2,6,68,51
2016-06-21,3707,1392,2315,1188,413,132,32,88,462
2016-06-22,0,0,0,0,0,0,0,0,0
2016-06-23,2894,1085,1809,607,562,91,41,90,418
2016-06-24,2529,984,1545,658,454,24,30,75,304
2016-06-25,674,381,293,96,113,9,19,12,44
2016-06-26,1258,787,471,220,145,12,22,26,46
2016-06-27,1668,997,671,343,92,4,40,95,97
2016-06-28,2888,908,1980,630,845,106,44,85,270
2016-06-29,2320,941,1379,656,413,2,30,108,170
2016-06-30,2478,886,1592,350,891,12,38,68,233
2016-07-01,2012,884,1128,597,230,25,26,60,190
2016-07-02,2201,1165,1036,578,171,17,25,39,206
2016-07-03,4363,2557,1806,1093,435,38,56,107,77
2016-07-04,2103,1067,1036,695,127,2,31,51,130
2016-07-05,2189,806,1383,404,647,82,26,92,132
2016-07-06,2893,773,2120,443,1156,150,22,70,279
2016-07-07,1655,952,703,315,121,34,37,89,107
2016-07-08,2559,887,1672,842,438,66,33,79,214
2016-07-09,4468,2387,2081,1148,446,47,72,63,305
2016-07-10,985,632,353,159,92,7,17,17,61
2016-07-11,1530,996,534,344,26,5,24,67,68
2016-07-12,2337,989,1348,409,311,205,40,75,308
2016-07-13,0,0,0,0,0,0,0,0,0
2016-07-14,1750,948,802,476,27,92,16,66,125
2016-07-15,2394,900,1494,720,347,34,39,95,259
2016-07-16,4621,1928,2693,914,531,56,390,111,691
2016-07-17,5031,2953,2078,1181,516,47,92,141,101
2016-07-18,4520,2555,1965,1096,493,88,66,139,83
2016-07-19,889,425,464,78,299,3,19,22,43
2016-07-20,1678,845,833,343,184,19,12,135,140
2016-07-21,1969,741,1228,283,584,40,32,90,199
2016-07-22,1863,965,898,529,125,13,34,83,114
2016-07-23,7848,4675,3173,1667,972,73,121,169,171
2016-07-24,5164,3058,2106,1313,470,65,72,111,75
2016-07-25,2453,1370,1083,567,208,28,36,150,94
2016-07-26,2993,1493,1500,743,371,48,65,138,135
2016-07-27,0,0,0,0,0,0,0,0,0
2016-07-28,1160,626,534,179,172,33,19,62,69
2016-07-29,722,384,338,79,107,63,19,10,60
2016-07-30,8007,4758,3249,1497,1176,138,99,170,169
2016-07-31,3906,2256,1650,871,474,75,61,81,88
2016-08-01,2595,1351,1244,479,505,73,47,73,67
2016-08-02,2379,1239,1140,471,443,88,20,64,54
2016-08-03,2718,1381,1337,582,479,62,48,89,77
2016-08-04,2528,1267,1261,499,435,74,62,85,106
2016-08-05,2385,1173,1212,530,392,95,27,78,90
2016-08-06,9245,5355,3890,1844,1426,185,139,134,162
2016-08-07,2870,1733,1137,596,321,69,45,46,60
2016-08-08,2962,1566,1396,660,477,73,20,77,89
2016-08-09,3531,1754,1777,837,579,91,29,125,116
2016-08-10,0,0,0,0,0,0,0,0,0
2016-08-11,5329,3085,2244,1308,556,96,72,132,80
2016-08-12,4253,2348,1905,898,618,120,62,125,82
2016-08-13,10091,6082,4009,1984,1286,276,129,199,135
2016-08-14,9483,5854,3629,1752,1161,275,130,184,127
2016-08-15,8725,5380,3345,1703,1017,209,120,169,127
2016-08-16,3068,1834,1234,650,343,74,48,72,47
2016-08-17,274,162,112,25,44,13,4,2,24
2016-08-18,3145,1726,1419,732,403,54,31,91,108
2016-08-19,3078,1609,1469,771,425,55,24,100,94
2016-08-20,2969,1850,1119,404,361,179,34,37,104
2016-08-21,2993,1779,1214,700,280,34,44,71,85
2016-08-22,509,339,170,44,37,16,7,4,62
2016-08-23,1130,683,447,205,107,41,17,40,37
2016-08-24,0,0,0,0,0,0,0,0,0
2016-08-25,3518,1656,1862,626,726,78,58,139,235
2016-08-26,1327,393,934,392,375,29,18,17,103
2016-08-27,14097,8615,5482,2780,1826,157,193,298,228
2016-08-28,6023,3522,2501,1628,492,43,97,124,117
2016-08-29,2738,1532,1206,815,158,10,21,92,110
2016-08-30,1908,712,1196,667,318,7,10,45,149
2016-08-31,2543,615,1928,443,1117,104,23,26,215
2016-09-01,2429,847,1582,895,417,11,17,44,198
2016-09-02,3887,1255,2632,1050,902,311,27,55,287
2016-09-03,4779,2647,2132,1281,411,36,55,146,203
2016-09-04,6020,3601,2419,1468,605,30,88,135,93
2016-09-05,2895,1288,1607,950,397,2,20,63,175
2016-09-06,1195,424,771,238,414,0,3,30,86
2016-09-07,4393,1437,2956,1363,1010,112,24,89,358
2016-09-08,3356,1163,2193,778,981,41,34,59,300
2016-09-09,1693,596,1097,352,580,13,12,14,126
2016-09-10,3849,2089,1760,966,375,29,72,61,257
2016-09-11,6633,3866,2767,1701,651,53,100,132,130
2016-09-12,3267,1582,1685,1083,231,9,47,140,175
2016-09-13,3860,1153,2707,1364,792,6,26,90,429
2016-09-14,0,0,0,0,0,0,0,0,0
2016-09-15,3902,1252,2650,887,1193,1,90,114,365
2016-09-16,4800,1331,3469,1558,1291,19,48,125,428
2016-09-17,3223,1905,1318,658,326,40,62,66,166
2016-09-18,7978,4386,3592,2395,711,64,112,155,155
2016-09-19,6399,3763,2636,1569,625,71,59,192,120
2016-09-20,2697,1270,1427,755,332,1,32,131,176
2016-09-21,3694,1178,2516,1130,740,4,57,189,396
2016-09-22,6601,3583,3018,1572,904,73,111,251,107
2016-09-23,1078,420,658,184,271,8,7,53,135
2016-09-24,4607,2692,1915,1117,425,24,67,180,102
2016-09-25,7720,4114,3606,1989,790,219,148,264,196
2016-09-26,2553,1276,1277,684,243,10,46,172,122
2016-09-27,4594,1470,3124,1415,1193,3,28,196,289
2016-09-28,0,0,0,0,0,0,0,0,0
2016-09-29,3604,1028,2576,1384,762,10,30,81,309
2016-09-30,2968,1234,1734,951,60,110,137,213,263
2016-10-01,5483,3116,2367,1308,513,43,86,227,190
2016-10-02,6707,3745,2962,1617,721,63,108,269,184
2016-10-03,1153,342,811,521,128,3,4,22,133
2016-10-04,2630,802,1828,949,518,2,17,64,278
2016-10-05,2447,877,1570,826,81,69,111,129,354
2016-10-06,1457,398,1059,538,259,27,11,20,204
2016-10-07,2674,957,1717,1164,58,26,18,76,375
2016-10-08,3765,2321,1444,738,399,38,71,99,99
2016-10-09,4838,2962,1876,995,526,48,74,132,101
2016-10-10,3540,2091,1449,707,448,58,54,83,99
2016-10-11,1664,807,857,475,133,9,15,108,117
2016-10-12,0,0,0,0,0,0,0,0,0
2016-10-13,2243,800,1443,775,273,18,48,111,218
2016-10-14,1840,809,1031,419,337,40,27,103,105
2016-10-15,4692,2600,2092,1168,469,57,89,192,117
2016-10-16,8136,4470,3666,2112,909,78,109,297,161
2016-10-17,1398,833,565,198,188,4,23,124,28
2016-10-18,1846,953,893,514,54,48,10,170,97
2016-10-19,2118,1178,940,445,115,12,45,230,93
2016-10-20,260,188,72,33,2,4,5,2,26
2016-10-21,794,464,330,189,5,52,22,29,33
2016-10-22,1662,1037,625,281,210,14,22,50,48
2016-10-23,2760,1731,1029,531,294,23,47,48,86
2016-10-24,762,535,227,154,21,2,6,28,16
2016-10-25,1317,789,528,335,14,1,16,106,56
2016-10-26,0,0,0,0,0,0,0,0,0
2016-10-27,1135,710,425,242,14,77,17,38,37
2016-10-28,1395,858,537,363,54,0,25,52,43
2016-10-29,1911,1115,796,385,267,23,28,35,58
2016-10-30,2049,1248,801,404,252,31,19,37,58
2016-10-31,265,143,122,27,65,1,4,5,20
2016-11-01,711,445,266,123,81,2,10,28,22
2016-11-02,847,356,491,244,122,37,8,28,52
2016-11-03,816,543,273,96,104,16,14,25,18
2016-11-04,962,658,304,169,31,14,10,34,46
2016-11-05,737,484,253,79,103,16,8,10,37
2016-11-06,27,15,12,1,3,0,1,0,7
2016-11-07,0,0,0,0,0,0,0,0,0
2016-11-08,0,0,0,0,0,0,0,0,0
2016-11-09,0,0,0,0,0,0,0,0,0
2016-11-10,0,0,0,0,0,0,0,0,0
2016-11-11,0,0,0,0,0,0,0,0,0
2016-11-12,2423,1552,871,460,232,21,45,63,50
2016-11-13,1873,1154,719,408,190,21,29,28,43
2016-11-14,1324,742,582,242,196,3,12,67,62
2016-11-15,283,221,62,31,2,0,9,11,9
2016-11-16,564,325,239,87,8,84,10,15,35
2016-11-17,542,373,169,86,0,13,9,21,40
2016-11-18,502,316,186,131,11,1,4,16,23
2016-11-19,2650,1567,1083,593,279,55,34,49,73
2016-11-20,1708,1144,564,303,171,16,29,20,25
2016-11-21,825,500,325,179,81,3,7,32,23
2016-11-22,451,238,213,140,10,18,4,14,27
2016-11-23,1237,764,473,255,134,28,13,27,16
2016-11-24,0,0,0,0,0,0,0,0,0
2016-11-25,441,276,165,47,59,18,10,16,15
2016-11-26,1261,780,481,251,121,19,19,28,43
2016-11-27,2030,1236,794,442,199,26,33,37,57
2016-11-28,485,382,103,55,33,1,5,8,1
2016-11-29,344,249,95,63,11,2,2,7,10
2016-11-30,282,218,64,31,3,0,3,17,10
2016-12-01,232,181,51,26,1,0,2,12,10
2016-12-02,231,153,78,52,1,0,2,5,18
2016-12-03,1829,1151,678,420,106,17,23,44,68
2016-12-04,3216,1892,1324,838,296,16,41,63,70
2016-12-05,662,503,159,89,29,2,8,18,13
2016-12-06,203,110,93,67,4,0,3,1,18
2016-12-07,314,231,83,21,19,1,7,7,28
2016-12-08,403,258,145,44,68,1,1,8,23
2016-12-09,346,212,134,77,16,1,8,5,27
2016-12-10,255,202,53,26,12,1,0,3,11
2016-12-11,598,431,167,72,44,13,9,7,22
2016-12-12,329,291,38,17,8,0,1,11,1
2016-12-13,359,307,52,21,15,3,2,8,3
2016-12-14,0,0,0,0,0,0,0,0,0
2016-12-15,363,296,67,39,6,1,3,8,10
2016-12-16,338,276,62,19,25,2,5,8,3
2016-12-17,849,622,227,92,51,11,18,17,38
2016-12-18,1345,939,406,199,104,15,14,23,51
2016-12-19,378,296,82,41,17,7,4,9,4
2016-12-20,310,224,86,30,29,0,1,8,18
2016-12-21,351,256,95,63,10,1,2,12,7
2016-12-22,265,195,70,29,25,2,0,10,4
2016-12-23,359,267,92,39,30,12,0,2,9
2016-12-24,755,583,172,78,56,10,5,11,12
2016-12-25,1202,936,266,119,79,16,12,11,29
2016-12-26,541,400,141,58,50,5,5,7,16
2016-12-27,727,467,260,111,75,26,5,18,25
2016-12-28,0,0,0,0,0,0,0,0,0
2016-12-29,0,0,0,0,0,0,0,0,0
2016-12-30,0,0,0,0,0,0,0,0,0
2016-12-31,0,0,0,0,0,0,0,0,0
2017-01-01,2546,1794,752,300,205,34,46,122,45
2017-01-02,2932,1949,983,429,305,47,45,128,29
2017-01-03,2156,1421,735,339,197,50,41,75,33
2017-01-04,1128,673,455,186,161,15,15,57,21
2017-01-05,969,583,386,164,135,28,8,30,21
2017-01-06,1053,559,494,217,134,50,16,30,47
2017-01-07,2313,1381,932,496,259,23,18,78,58
2017-01-08,2441,1574,867,457,230,36,43,56,45
2017-01-09,1142,742,400,168,126,34,23,19,30
2017-01-10,619,367,252,86,76,17,7,26,40
2017-01-11,0,0,0,0,0,0,0,0,0
2017-01-12,726,234,492,184,187,21,12,12,76
2017-01-13,601,352,249,62,117,11,13,22,24
2017-01-14,1150,731,419,179,93,24,20,55,48
2017-01-15,1283,805,478,269,115,23,15,29,27
2017-01-16,628,339,289,123,88,7,2,26,43
2017-01-17,795,436,359,222,66,1,8,24,38
2017-01-18,590,358,232,133,34,4,3,22,36
2017-01-19,432,307,125,64,16,3,7,7,28
2017-01-20,441,281,160,99,11,2,7,16,25
2017-01-21,1593,983,610,345,158,8,21,41,37
2017-01-22,1282,790,492,276,129,19,10,20,38
2017-01-23,456,292,164,91,28,4,5,5,31
2017-01-24,278,221,57,18,17,2,1,13,6
2017-01-25,0,0,0,0,0,0,0,0,0
2017-01-26,685,505,180,75,39,1,10,27,28
2017-01-27,544,155,389,339,10,1,3,3,33
2017-01-28,737,551,186,88,47,8,20,10,13
2017-01-29,1917,1183,734,464,184,6,21,28,31
2017-01-30,500,378,122,64,35,1,10,9,3
2017-01-31,778,320,458,357,35,3,5,9,49
2017-02-01,465,270,195,141,19,1,6,13,15
2017-02-02,550,331,219,160,19,8,2,6,24
2017-02-03,480,307,173,102,19,3,4,27,18
2017-02-04,1263,811,452,210,144,12,15,18,53
2017-02-05,2392,1429,963,482,268,18,34,51,110
2017-02-06,820,442,378,171,133,1,2,16,55
2017-02-07,1089,595,494,381,19,2,5,28,59
2017-02-08,872,459,413,282,74,3,5,6,43
2017-02-09,1431,688,743,371,210,10,15,35,102
2017-02-10,1228,626,602,471,27,5,12,23,64
2017-02-11,5177,3086,2091,1119,730,28,58,80,76
2017-02-12,3493,2159,1334,760,411,11,42,58,52
2017-02-13,990,740,250,197,13,1,5,12,22
2017-02-14,888,490,398,305,15,0,5,18,55
2017-02-15,694,418,276,211,6,0,8,18,33
2017-02-16,733,534,199,126,10,1,3,35,24
2017-02-17,670,313,357,295,5,1,8,3,45
2017-02-18,1450,952,498,262,155,6,16,22,37
2017-02-19,1561,982,579,322,146,17,23,21,50
2017-02-20,575,453,122,77,18,1,5,16,5
2017-02-21,435,340,95,51,7,2,5,13,17
2017-02-22,0,0,0,0,0,0,0,0,0
2017-02-23,588,394,194,112,6,2,5,13,56
2017-02-24,468,363,105,62,8,0,2,9,24
2017-02-25,1492,931,561,327,108,25,23,23,55
2017-02-26,1189,773,416,204,136,20,11,22,23
2017-02-27,628,510,118,71,4,4,8,20,11
2017-02-28,682,509,173,106,11,1,3,35,17
2017-03-01,561,414,147,92,10,3,7,24,11
2017-03-02,707,492,215,131,16,17,7,20,24
2017-03-03,483,228,255,221,2,1,1,1,29
2017-03-04,1425,962,463,264,119,17,11,25,27
2017-03-05,2228,1400,828,525,196,12,22,34,39
2017-03-06,926,677,249,192,11,2,7,23,14
2017-03-07,629,533,96,59,10,1,4,17,5
2017-03-08,0,0,0,0,0,0,0,0,0
2017-03-09,665,553,112,82,2,1,2,18,7
2017-03-10,560,442,118,76,9,3,4,13,13
2017-03-11,1869,1205,664,433,125,19,23,37,27
2017-03-12,3310,2064,1246,843,224,40,31,57,51
2017-03-13,926,726,200,124,11,9,12,35,9
2017-03-14,938,757,181,105,18,5,6,22,25
2017-03-15,864,637,227,139,17,18,14,22,17
2017-03-16,682,437,245,181,7,15,6,10,26
2017-03-17,671,510,161,103,25,6,6,14,7
2017-03-18,2358,1460,898,554,163,45,41,55,40
2017-03-19,4470,2777,1693,1088,361,52,53,63,76
2017-03-20,4823,2873,1950,1325,382,64,51,77,51
2017-03-21,919,606,313,139,108,11,6,19,30
2017-03-22,0,0,0,0,0,0,0,0,0
2017-03-23,581,432,149,73,28,14,0,8,26
2017-03-24,603,380,223,142,21,12,10,12,26
2017-03-25,1563,1010,553,294,121,35,27,43,33
2017-03-26,3674,2166,1508,908,368,69,47,66,50
2017-03-27,2080,1169,911,434,254,67,30,90,36
2017-03-28,1689,903,786,367,228,43,36,52,60
2017-03-29,1770,925,845,392,291,35,16,68,43
2017-03-30,733,380,353,128,149,27,8,22,19
2017-03-31,1689,826,863,372,291,58,13,72,57
2017-04-01,3375,1864,1511,858,402,49,47,106,49
2017-04-02,4107,2374,1733,1081,430,46,45,72,59
2017-04-03,1952,1093,859,381,302,41,36,58,41
2017-04-04,2257,1127,1130,482,413,52,20,87,76
2017-04-05,3453,1730,1723,1028,378,58,41,159,59
2017-04-06,1698,1027,671,462,84,14,23,59,29
2017-04-07,733,453,280,202,13,3,11,30,21
2017-04-08,1097,706,391,213,116,15,14,11,22
2017-04-09,4058,2500,1558,1022,327,29,38,57,85
2017-04-10,0,0,0,0,0,0,0,0,0
2017-04-11,0,0,0,0,0,0,0,0,0
2017-04-12,0,0,0,0,0,0,0,0,0
2017-04-13,0,0,0,0,0,0,0,0,0
2017-04-14,0,0,0,0,0,0,0,0,0
2017-04-15,5546,3366,2180,1433,462,28,62,104,91
2017-04-16,6576,3964,2612,1680,600,34,79,118,101
2017-04-17,1680,1100,580,360,84,6,25,83,22
2017-04-18,240,186,54,31,7,1,1,2,12
2017-04-19,465,334,131,64,10,1,19,8,29
2017-04-20,491,363,128,43,19,2,16,20,28
2017-04-21,969,699,270,145,32,2,14,57,20
2017-04-22,785,558,227,78,54,16,12,7,60
2017-04-23,4410,2756,1654,1012,355,63,66,101,57
2017-04-24,1610,1033,577,356,48,4,18,137,14
2017-04-25,1066,693,373,214,21,0,20,71,47
2017-04-26,0,0,0,0,0,0,0,0,0
2017-04-27,1032,792,240,127,15,4,19,44,31
2017-04-28,1606,965,641,317,38,56,35,129,66
2017-04-29,4997,2893,2104,1246,429,85,65,203,76
2017-04-30,3794,2326,1468,825,336,41,43,171,52
2017-05-01,2540,1770,770,449,101,22,42,96,60
2017-05-02,4396,2855,1541,973,97,32,62,283,94
2017-05-03,14380,8410,5970,3046,1540,159,256,724,245
2017-05-04,18169,10572,7597,4233,1591,246,337,899,291
2017-05-05,16057,9240,6817,3841,1548,245,258,676,249
2017-05-06,3628,2384,1244,664,321,72,43,96,48
2017-05-07,6725,4061,2664,1360,727,133,93,234,117
2017-05-08,983,606,377,117,11,1,27,192,29
2017-05-09,2337,1279,1058,616,10,133,44,168,87
2017-05-10,0,0,0,0,0,0,0,0,0
2017-05-11,866,332,534,160,40,157,49,30,98
2017-05-12,1840,1032,808,430,12,116,28,95,127
2017-05-13,3477,1992,1485,893,233,57,59,130,113
2017-05-14,1287,817,470,226,123,39,14,30,38
2017-05-15,789,564,225,134,10,16,14,18,33
2017-05-16,745,324,421,54,64,190,26,12,75
2017-05-17,2183,1096,1087,415,22,381,38,89,142
2017-05-18,2614,1113,1501,774,111,228,60,119,209
2017-05-19,2807,1178,1629,1008,72,195,28,87,239
2017-05-20,5528,3104,2424,1328,466,160,96,117,257
2017-05-21,5638,3431,2207,1283,521,82,80,138,103
2017-05-22,1501,823,678,503,15,27,19,45,69
2017-05-23,2080,1004,1076,840,17,13,21,42,143
2017-05-24,0,0,0,0,0,0,0,0,0
2017-05-25,2344,815,1529,1002,25,128,36,74,264
2017-05-26,3699,1704,1995,1409,43,66,62,122,293
2017-05-27,539,368,171,62,18,39,20,11,21
2017-05-28,1572,932,640,281,109,13,20,25,192
2017-05-29,3042,1645,1397,617,423,72,47,113,125
2017-05-30,2250,1136,1114,643,63,143,39,87,139
2017-05-31,2121,1036,1085,696,25,63,52,94,155
2017-06-01,1153,492,661,346,8,213,14,11,69
2017-06-02,2197,864,1333,815,18,249,30,48,173
2017-06-03,1725,852,873,346,179,99,28,32,189
2017-06-04,871,623,248,127,45,14,12,16,34
2017-06-05,2905,1278,1627,624,485,219,44,152,103
2017-06-06,2015,1106,909,524,73,8,26,127,151
2017-06-07,2110,1062,1048,658,51,45,26,100,168
2017-06-08,1256,417,839,217,47,451,11,23,90
2017-06-09,3093,1325,1768,1013,193,180,16,73,293
2017-06-10,1605,830,775,366,169,5,126,17,92
2017-06-11,2094,1337,757,437,174,16,39,31,60
2017-06-12,2152,1194,958,543,151,2,35,75,152
2017-06-13,2890,1335,1555,1025,209,15,31,92,183
2017-06-14,0,0,0,0,0,0,0,0,0
2017-06-15,1025,414,611,446,48,5,6,19,87
2017-06-16,3499,1354,2145,998,737,3,30,73,304
2017-06-17,6966,3898,3068,1917,521,59,101,136,334
2017-06-18,8210,4971,3239,2159,591,64,98,189,138
2017-06-19,2172,1186,986,647,56,5,44,87,147
2017-06-20,2579,932,1647,715,524,2,51,81,274
2017-06-21,2363,1064,1299,747,138,7,76,68,263
2017-06-22,1081,435,646,229,265,10,8,9,125
2017-06-23,3380,1316,2064,967,726,4,25,50,292
2017-06-24,4735,2585,2150,1368,318,26,68,65,305
2017-06-25,737,455,282,74,115,7,27,10,49
2017-06-26,2321,777,1544,224,1145,9,9,22,135
2017-06-27,2443,1025,1418,519,539,7,38,71,244
2017-06-28,0,0,0,0,0,0,0,0,0
2017-06-29,2645,928,1717,517,829,22,29,119,201
2017-06-30,2530,1015,1515,472,615,34,30,76,288
2017-07-01,4452,2539,1913,1201,389,38,51,92,142
2017-07-02,3614,2129,1485,858,317,45,119,59,87
2017-07-03,1507,779,728,371,144,1,33,35,144
2017-07-04,1504,510,994,108,540,230,12,20,84
2017-07-05,2444,895,1549,907,280,70,33,59,200
2017-07-06,1789,857,932,386,181,181,26,53,105
2017-07-07,2576,982,1594,595,703,30,13,60,193
2017-07-08,2893,1717,1176,673,245,36,42,43,137
2017-07-09,3552,2184,1368,853,277,44,52,46,96
2017-07-10,792,560,232,139,20,4,11,24,34
2017-07-11,1231,539,692,216,286,64,17,36,73
2017-07-12,0,0,0,0,0,0,0,0,0
2017-07-13,1434,698,736,265,150,177,16,48,80
2017-07-14,1585,540,1045,454,185,114,14,46,232
2017-07-15,2137,1363,774,438,127,42,31,52,84
2017-07-16,1091,718,373,199,60,6,23,14,71
2017-07-17,2323,1449,874,492,221,45,36,40,40
2017-07-18,1349,649,700,181,193,51,22,44,209
2017-07-19,1855,786,1069,310,282,208,27,119,123
2017-07-20,1118,624,494,250,68,5,22,41,108
2017-07-21,1499,693,806,458,116,73,28,35,96
2017-07-22,2945,1722,1223,713,285,30,52,58,85
2017-07-23,3778,2183,1595,992,359,39,59,83,63
2017-07-24,1788,1062,726,490,91,10,23,51,61
2017-07-25,2057,1090,967,567,176,28,45,73,78
2017-07-26,0,0,0,0,0,0,0,0,0
2017-07-27,2885,1482,1403,694,418,72,43,99,77
2017-07-28,1860,766,1094,421,322,117,15,59,160
2017-07-29,5050,2118,2932,1051,591,77,379,106,728
2017-07-30,4827,2784,2043,1208,495,104,62,98,76
2017-07-31,894,479,415,140,161,21,17,36,40
2017-08-01,3188,1596,1592,707,554,77,57,109,88
2017-08-02,3309,1578,1731,686,665,71,56,125,128
2017-08-03,3658,1737,1921,907,659,75,52,142,86
2017-08-04,3212,1612,1600,718,480,89,40,140,133
2017-08-05,3782,2152,1630,846,420,95,58,110,101
2017-08-06,4611,2651,1960,1144,465,76,73,97,105
2017-08-07,3464,1868,1596,698,596,83,51,83,85
2017-08-08,3503,1799,1704,724,611,119,43,116,91
2017-08-09,0,0,0,0,0,0,0,0,0
2017-08-10,3969,2057,1912,952,568,74,47,120,151
2017-08-11,11146,6491,4655,2278,1586,260,143,248,140
2017-08-12,2234,1462,772,340,265,60,36,34,37
2017-08-13,9838,5938,3900,2026,1153,212,156,186,167
2017-08-14,6763,3841,2922,1582,739,161,108,233,99
2017-08-15,7175,4041,3134,1676,828,163,105,244,118
2017-08-16,5711,3158,2553,1314,659,130,85,226,139
2017-08-17,4158,2274,1884,956,484,61,49,155,179
2017-08-18,11085,6410,4675,2264,1584,190,149,254,234
2017-08-19,15840,9386,6454,3646,1834,268,184,312,210
2017-08-20,5931,3436,2495,1339,575,174,99,142,166
2017-08-21,2544,1613,931,497,169,64,31,110,60
2017-08-22,570,321,249,83,40,43,2,16,65
2017-08-23,0,0,0,0,0,0,0,0,0
2017-08-24,2106,842,1264,667,301,104,19,23,150
2017-08-25,3524,1551,1973,1071,473,90,39,80,220
2017-08-26,4043,2390,1653,969,351,37,68,106,122
2017-08-27,5026,2970,2056,1246,476,65,66,114,89
2017-08-28,2367,1392,975,557,227,8,30,77,76
2017-08-29,1864,660,1204,174,882,13,11,26,98
2017-08-30,2815,1172,1643,713,574,11,32,131,182
2017-08-31,3398,999,2399,667,1286,38,33,104,271
2017-09-01,3376,1357,2019,1162,359,119,29,124,226
2017-09-02,4540,2543,1997,1162,414,44,62,108,207
2017-09-03,5202,3156,2046,1290,429,48,76,115,88
2017-09-04,2801,1249,1552,1040,195,3,24,117,173
2017-09-05,3123,1225,1898,716,812,18,34,96,222
2017-09-06,3052,1189,1863,905,459,60,48,80,311
2017-09-07,3761,1247,2514,1073,1045,15,29,53,299
2017-09-08,5945,1535,4410,1853,1842,97,37,87,494
2017-09-09,4080,2402,1678,997,343,33,70,61,174
2017-09-10,5139,3047,2092,1274,466,30,72,131,119
2017-09-11,2990,1298,1692,653,805,9,31,67,127
2017-09-12,844,259,585,113,349,1,3,4,115
2017-09-13,0,0,0,0,0,0,0,0,0
2017-09-14,2692,934,1758,428,1061,2,31,36,200
2017-09-15,5600,1324,4276,1859,1895,2,24,70,426
2017-09-16,4693,2733,1960,1133,409,41,84,154,139
2017-09-17,5689,3466,2223,1304,545,76,79,101,118
2017-09-18,401,335,66,22,13,5,9,2,15
2017-09-19,2546,870,1676,513,880,5,8,56,214
2017-09-20,3059,689,2370,1290,661,0,15,51,353
2017-09-21,4276,834,3442,1314,1655,5,24,69,375
2017-09-22,4350,1372,2978,977,1556,18,49,103,275
2017-09-23,3383,1730,1653,692,296,34,44,105,482
2017-09-24,6188,3703,2485,1524,537,50,142,100,132
2017-09-25,1989,1197,792,357,176,18,65,70,106
2017-09-26,3685,1134,2551,956,1127,0,38,118,312
2017-09-27,0,0,0,0,0,0,0,0,0
2017-09-28,3240,687,2553,1601,582,1,16,32,321
2017-09-29,1862,894,968,712,23,14,18,73,128
2017-09-30,3067,1790,1277,717,241,31,46,131,111
2017-10-01,6325,3696,2629,1540,618,59,95,201,116
2017-10-02,1684,699,985,388,331,8,9,45,204
2017-10-03,1287,412,875,560,88,4,5,18,200
2017-10-04,882,328,554,320,22,48,9,38,117
2017-10-05,2060,757,1303,940,109,4,21,64,165
2017-10-06,2534,794,1740,1074,92,5,91,109,369
2017-10-07,2660,1552,1108,599,264,39,35,84,87
2017-10-08,6444,3686,2758,1713,628,41,90,177,109
2017-10-09,5863,3282,2581,1527,646,57,80,172,99
2017-10-10,1244,629,615,167,303,15,24,26,80
2017-10-11,0,0,0,0,0,0,0,0,0
2017-10-12,621,352,269,181,9,10,7,11,51
2017-10-13,1215,635,580,357,92,12,24,39,56
2017-10-14,3663,2029,1634,902,369,32,84,139,108
2017-10-15,4348,2573,1775,1037,490,57,43,81,67
2017-10-16,1894,963,931,478,244,0,23,138,48
2017-10-17,837,507,330,134,48,39,20,23,66
2017-10-18,1118,630,488,383,16,1,10,26,52
2017-10-19,2166,1090,1076,620,216,51,36,58,95
2017-10-20,1340,707,633,359,92,0,9,41,132
2017-10-21,3860,2168,1692,981,409,24,57,120,101
2017-10-22,2661,1566,1095,636,264,42,31,63,59
2017-10-23,116,92,24,12,3,0,2,5,2
2017-10-24,1075,652,423,178,147,0,11,63,24
2017-10-25,0,0,0,0,0,0,0,0,0
2017-10-26,1300,874,426,253,18,0,22,108,25
2017-10-27,1206,768,438,267,21,10,19,94,27
2017-10-28,3396,1896,1500,874,369,23,67,86,81
2017-10-29,2911,1796,1115,699,254,28,34,39,61
2017-10-30,149,125,24,3,6,0,5,3,7
2017-10-31,690,487,203,155,4,3,8,19,14
2017-11-01,1442,661,781,410,201,44,15,80,31
2017-11-02,1207,674,533,284,96,10,15,83,45
2017-11-03,2439,1440,999,584,254,22,34,61,44
2017-11-04,1997,1237,760,360,254,23,31,31,61
2017-11-05,3285,2104,1181,707,310,24,33,51,56
2017-11-06,0,0,0,0,0,0,0,0,0
2017-11-07,0,0,0,0,0,0,0,0,0
2017-11-08,0,0,0,0,0,0,0,0,0
2017-11-09,0,0,0,0,0,0,0,0,0
2017-11-10,0,0,0,0,0,0,0,0,0
2017-11-11,565,406,159,29,79,8,6,7,30
2017-11-12,2012,1281,731,410,197,14,26,32,52
2017-11-13,949,603,346,188,103,5,6,28,16
2017-11-14,669,408,261,157,5,0,15,20,64
2017-11-15,417,300,117,58,4,15,5,8,27
2017-11-16,553,416,137,57,4,22,11,21,22
2017-11-17,693,474,219,137,11,3,11,37,20
2017-11-18,982,680,302,108,95,11,13,32,43
2017-11-19,540,386,154,50,47,8,6,4,39
2017-11-20,529,405,124,61,28,5,4,8,18
2017-11-21,533,324,209,49,11,114,2,10,23
2017-11-22,0,0,0,0,0,0,0,0,0
2017-11-23,1001,666,335,127,111,6,21,20,50
2017-11-24,535,448,87,52,14,2,5,8,6
2017-11-25,1212,805,407,132,178,10,15,14,58
2017-11-26,1112,787,325,159,61,13,14,27,51
2017-11-27,549,423,126,69,23,3,9,13,9
2017-11-28,562,413,149,92,16,3,4,21,13
2017-11-29,369,277,92,44,8,2,12,8,18
2017-11-30,368,290,78,36,12,4,4,13,9
2017-12-01,400,269,131,91,8,1,4,10,17
2017-12-02,897,620,277,156,51,16,11,14,29
2017-12-03,1278,834,444,226,126,8,15,18,51
2017-12-04,694,471,223,134,45,3,11,14,16
2017-12-05,431,302,129,99,6,0,2,6,16
2017-12-06,340,291,49,21,7,0,6,9,6
2017-12-07,443,343,100,33,18,1,0,41,7
2017-12-08,482,275,207,70,77,7,3,8,42
2017-12-09,926,649,277,94,85,11,12,13,62
2017-12-10,1339,868,471,233,129,25,26,21,37
2017-12-11,420,335,85,43,16,0,6,9,11
2017-12-12,452,284,168,111,17,4,4,6,26
2017-12-13,0,0,0,0,0,0,0,0,0
2017-12-14,710,542,168,116,11,3,4,10,24
2017-12-15,407,327,80,40,14,5,1,15,5
2017-12-16,744,543,201,93,49,12,9,7,31
2017-12-17,1333,936,397,233,71,20,17,10,46
2017-12-18,449,347,102,52,24,4,3,7,12
2017-12-19,391,310,81,39,18,5,3,3,13
2017-12-20,470,346,124,68,34,4,5,8,5
2017-12-21,381,305,76,37,24,5,1,7,2
2017-12-22,479,388,91,47,13,3,8,11,9
2017-12-23,1214,899,315,190,66,7,9,21,22
2017-12-24,1643,1233,410,197,106,27,24,14,42
2017-12-25,776,596,180,74,66,18,4,7,11
2017-12-26,663,467,196,81,58,14,7,5,31
2017-12-27,0,0,0,0,0,0,0,0,0
2017-12-28,1331,945,386,183,130,16,10,22,25
2017-12-29,0,0,0,0,0,0,0,0,0
2017-12-30,0,0,0,0,0,0,0,0,0
2017-12-31,0,0,0,0,0,0,0,0,0
2018-01-01,2343,1686,657,262,177,28,40,113,37
2018-01-02,2226,1532,694,309,184,25,38,106,32
2018-01-03,2487,1657,830,420,198,54,42,85,31
2018-01-04,1482,883,599,257,198,34,23,44,43
2018-01-05,1353,855,498,256,143,30,16,33,20
2018-01-06,1503,996,507,284,108,26,19,36,34
2018-01-07,1808,1227,581,337,102,33,24,38,47
2018-01-08,1842,1165,677,404,153,22,16,46,36
2018-01-09,670,325,345,115,111,36,12,11,60
2018-01-10,0,0,0,0,0,0,0,0,0
2018-01-11,918,528,390,158,140,16,10,31,35
2018-01-12,804,402,402,215,106,12,6,29,34
2018-01-13,1217,840,377,223,89,9,17,21,18
2018-01-14,1795,1168,627,382,139,10,20,44,32
2018-01-15,635,388,247,112,90,3,6,15,21
2018-01-16,933,464,469,228,151,1,7,35,47
2018-01-17,798,468,330,203,71,2,8,32,14
2018-01-18,553,338,215,83,83,2,3,18,26
2018-01-19,649,379,270,109,110,1,8,24,18
2018-01-20,1547,973,574,351,120,34,18,24,27
2018-01-21,1342,872,470,284,84,10,21,21,50
2018-01-22,353,292,61,32,7,2,7,7,6
2018-01-23,578,488,90,53,19,1,3,10,4
2018-01-24,0,0,0,0,0,0,0,0,0
2018-01-25,240,176,64,25,13,0,4,4,18
2018-01-26,550,273,277,233,8,0,2,8,26
2018-01-27,937,645,292,148,68,10,13,22,31
2018-01-28,1525,977,548,309,114,13,30,25,57
2018-01-29,556,382,174,115,27,0,5,13,14
2018-01-30,567,341,226,168,16,2,7,11,22
2018-01-31,366,247,119,65,19,0,7,13,15
2018-02-01,704,399,305,188,39,12,3,17,46
2018-02-02,540,431,109,67,22,2,4,11,3
2018-02-03,1148,808,340,192,91,7,14,26,10
2018-02-04,1739,1123,616,292,129,13,20,25,137
2018-02-05,683,533,150,79,26,3,8,5,29
2018-02-06,1423,1034,389,281,24,7,13,16,48
2018-02-07,1250,718,532,386,25,0,12,27,82
2018-02-08,1079,666,413,274,38,3,9,38,51
2018-02-09,1107,693,414,308,32,6,9,7,52
2018-02-10,1686,1154,532,320,110,10,19,32,41
2018-02-11,2242,1551,691,381,203,19,23,30,35
2018-02-12,1771,1269,502,277,119,10,18,47,31
2018-02-13,862,741,121,69,18,2,10,7,15
2018-02-14,0,0,0,0,0,0,0,0,0
2018-02-15,824,454,370,304,19,1,2,8,36
2018-02-16,1323,479,844,669,78,0,6,20,71
2018-02-17,1093,785,308,201,58,8,15,10,16
2018-02-18,1619,1060,559,310,152,15,22,12,48
2018-02-19,729,497,232,122,58,2,7,20,23
2018-02-20,767,498,269,221,15,1,4,5,23
2018-02-21,710,534,176,118,12,7,3,21,15
2018-02-22,711,544,167,84,23,3,8,20,29
2018-02-23,662,438,224,156,24,6,4,22,12
2018-02-24,1405,932,473,293,98,8,17,34,23
2018-02-25,1937,1237,700,423,170,24,16,27,40
2018-02-26,643,512,131,85,10,1,4,23,8
2018-02-27,769,587,182,109,21,1,6,35,10
2018-02-28,0,0,0,0,0,0,0,0,0
2018-03-01,258,190,68,48,4,0,1,2,13
2018-03-02,138,122,16,7,5,1,1,1,1
2018-03-03,1287,909,378,224,72,22,12,29,19
2018-03-04,1480,952,528,319,107,25,21,15,41
2018-03-05,541,459,82,50,3,3,3,10,13
2018-03-06,762,543,219,163,8,0,4,18,26
2018-03-07,636,546,90,61,6,1,6,12,4
2018-03-08,560,379,181,125,7,11,4,5,29
2018-03-09,259,204,55,6,1,1,3,1,43
2018-03-10,1724,1154,570,318,133,18,23,18,60
2018-03-11,2714,1687,1027,616,222,56,30,47,56
2018-03-12,695,513,182,127,19,3,9,6,18
2018-03-13,1986,1422,564,270,22,29,34,144,65
2018-03-14,0,0,0,0,0,0,0,0,0
2018-03-15,2135,1533,602,318,33,30,34,144,43
2018-03-16,1679,1163,516,336,22,11,26,80,41
2018-03-17,3786,2406,1380,721,310,60,76,126,87
2018-03-18,6884,4314,2570,1535,542,71,95,236,91
2018-03-19,2347,1637,710,367,113,36,29,124,41
2018-03-20,1726,1136,590,281,127,22,31,94,35
2018-03-21,6003,3686,2317,1395,474,83,84,207,74
2018-03-22,2221,1437,784,388,108,62,36,142,48
2018-03-23,2458,1528,930,523,106,60,34,155,52
2018-03-24,5514,3439,2075,1279,407,82,60,190,57
2018-03-25,8405,4888,3517,2044,874,159,107,226,107
2018-03-26,4554,2424,2130,959,655,120,79,237,80
2018-03-27,6012,3082,2930,1392,859,147,91,341,100
2018-03-28,0,0,0,0,0,0,0,0,0
2018-03-29,6337,3057,3280,1393,1042,182,89,455,119
2018-03-30,4578,2221,2357,1045,724,124,49,332,83
2018-03-31,8081,4469,3612,2031,865,156,129,297,134
2018-04-01,4054,2384,1670,752,634,62,56,103,63
2018-04-02,6216,3154,3062,1275,1198,95,78,350,66
2018-04-03,1944,1017,927,316,387,51,25,88,60
2018-04-04,3890,1961,1929,846,651,107,52,180,93
2018-04-05,2961,1467,1494,521,585,97,45,171,75
2018-04-06,958,534,424,238,52,23,29,39,43
2018-04-07,1704,1151,553,198,212,38,32,32,41
2018-04-08,5527,3482,2045,1134,570,84,65,96,96
2018-04-09,0,0,0,0,0,0,0,0,0
2018-04-10,0,0,0,0,0,0,0,0,0
2018-04-11,0,0,0,0,0,0,0,0,0
2018-04-12,0,0,0,0,0,0,0,0,0
2018-04-13,0,0,0,0,0,0,0,0,0
2018-04-14,4819,3182,1637,819,483,52,80,126,77
2018-04-15,1933,1427,506,262,126,15,22,27,54
2018-04-16,2375,1725,650,308,119,9,35,148,31
2018-04-17,3335,2215,1120,559,66,6,73,360,56
2018-04-18,3794,2503,1291,754,37,2,102,296,100
2018-04-19,2882,1814,1068,554,25,2,67,348,72
2018-04-20,2583,1639,944,481,77,7,82,242,55
2018-04-21,9509,5747,3762,2352,812,85,145,181,187
2018-04-22,8910,5352,3558,2034,929,110,143,199,143
2018-04-23,2565,1710,855,385,144,9,69,194,54
2018-04-24,2137,1560,577,241,59,39,55,137,46
2018-04-25,0,0,0,0,0,0,0,0,0
2018-04-26,2262,1684,578,241,32,37,36,140,92
2018-04-27,1856,1294,562,273,19,15,50,165,40
2018-04-28,6753,3857,2896,1490,642,107,135,376,146
2018-04-29,17369,10106,7263,3889,1970,200,261,722,221
2018-04-30,14956,8881,6075,3222,1303,189,244,903,214
2018-05-01,6571,4186,2385,1162,150,38,125,807,103
2018-05-02,4651,3068,1583,759,155,51,78,389,151
2018-05-03,3425,2345,1080,513,308,71,53,71,64
2018-05-04,13826,8383,5443,2683,1603,202,228,518,209
2018-05-05,10389,6198,4191,2048,1278,215,165,315,170
2018-05-06,3309,1936,1373,598,412,96,79,101,87
2018-05-07,2611,1613,998,389,35,4,68,435,67
2018-05-08,2418,1351,1067,422,36,179,52,295,83
2018-05-09,0,0,0,0,0,0,0,0,0
2018-05-10,2102,1063,1039,422,16,200,92,184,125
2018-05-11,3312,1888,1424,679,52,107,108,291,187
2018-05-12,8322,4659,3663,2028,749,111,142,383,250
2018-05-13,1475,940,535,231,115,23,51,37,78
2018-05-14,1695,1053,642,356,16,73,32,97,68
2018-05-15,3072,1782,1290,601,57,196,59,261,116
2018-05-16,2928,1766,1162,602,46,69,77,271,97
2018-05-17,1527,625,902,271,36,276,44,84,191
2018-05-18,2773,1340,1433,929,105,50,56,39,254
2018-05-19,1152,705,447,139,96,103,16,27,66
2018-05-20,8059,4883,3176,1707,655,88,124,234,368
2018-05-21,3403,1927,1476,828,90,119,60,251,128
2018-05-22,3160,1592,1568,913,24,162,50,219,200
2018-05-23,0,0,0,0,0,0,0,0,0
2018-05-24,4498,1874,2624,1612,32,389,73,199,319
2018-05-25,3617,1591,2026,1344,40,129,58,208,247
2018-05-26,5150,3159,1991,1220,289,66,81,169,166
2018-05-27,7754,4787,2967,1777,691,54,113,210,122
2018-05-28,3522,1752,1770,516,872,13,78,204,87
2018-05-29,3139,1709,1430,939,19,8,65,233,166
2018-05-30,2482,1314,1168,583,49,85,65,162,224
2018-05-31,1195,501,694,179,2,378,28,48,59
2018-06-01,4657,1792,2865,1746,203,400,58,179,279
2018-06-02,5288,3177,2111,1334,375,33,71,167,131
2018-06-03,6494,3965,2529,1603,557,46,85,148,90
2018-06-04,3690,1970,1720,779,573,15,55,181,117
2018-06-05,2816,1536,1280,880,47,5,30,138,180
2018-06-06,2706,1534,1172,670,107,47,45,148,155
2018-06-07,2839,1318,1521,749,57,250,78,117,270
2018-06-08,1806,827,979,561,22,165,20,32,179
2018-06-09,3415,1909,1506,669,271,40,51,93,382
2018-06-10,6688,4133,2555,1702,448,38,91,158,118
2018-06-11,1974,1089,885,417,165,3,25,112,163
2018-06-12,823,397,426,117,243,0,8,7,51
2018-06-13,0,0,0,0,0,0,0,0,0
2018-06-14,2407,1140,1267,751,134,0,37,96,249
2018-06-15,3733,1570,2163,1065,592,8,44,140,314
2018-06-16,5929,3292,2637,1585,396,89,100,173,294
2018-06-17,6315,3789,2526,1597,438,60,83,157,191
2018-06-18,2355,1373,982,528,71,4,40,183,156
2018-06-19,4473,1982,2491,885,897,112,50,166,381
2018-06-20,1948,897,1051,421,138,12,36,144,300
2018-06-21,2478,1090,1388,424,338,252,36,109,229
2018-06-22,4509,1917,2592,1201,634,30,56,193,478
2018-06-23,6452,3560,2892,1943,360,31,98,162,298
2018-06-24,5227,3195,2032,1248,387,64,74,141,118
2018-06-25,2161,1348,813,426,139,5,27,98,118
2018-06-26,3281,1655,1626,408,696,32,43,207,240
2018-06-27,0,0,0,0,0,0,0,0,0
2018-06-28,2672,1158,1514,346,686,82,55,112,233
2018-06-29,2190,773,1417,421,588,65,34,43,266
2018-06-30,5370,2995,2375,1461,371,34,88,156,265
2018-07-01,1786,1234,552,285,92,35,38,32,70
2018-07-02,937,520,417,260,17,3,19,59,59
2018-07-03,1492,603,889,167,539,44,16,24,99
2018-07-04,1188,707,481,104,261,11,15,17,73
2018-07-05,645,220,425,25,160,178,7,7,48
2018-07-06,3530,1295,2235,682,991,164,46,132,220
2018-07-07,3893,2271,1622,1048,207,36,94,97,140
2018-07-08,6434,3886,2548,1706,366,67,96,181,132
2018-07-09,1655,962,693,368,73,1,36,83,132
2018-07-10,1646,827,819,347,238,28,26,43,137
2018-07-11,0,0,0,0,0,0,0,0,0
2018-07-12,2933,1507,1426,531,235,162,48,239,211
2018-07-13,1770,730,1040,649,55,29,22,53,232
2018-07-14,5900,3684,2216,1327,365,58,82,191,193
2018-07-15,1929,1320,609,344,108,31,33,40,53
2018-07-16,5370,3264,2106,1289,410,98,74,158,77
2018-07-17,2709,1400,1309,417,460,95,31,142,164
2018-07-18,3251,1492,1759,574,536,52,61,316,220
2018-07-19,2488,1101,1387,525,194,335,48,173,112
2018-07-20,2514,1187,1327,543,349,81,50,166,138
2018-07-21,3765,2256,1509,903,233,36,61,104,172
2018-07-22,4616,2812,1804,1161,297,63,67,130,86
2018-07-23,2958,1823,1135,712,158,5,37,168,55
2018-07-24,2900,1738,1162,722,136,14,56,138,96
2018-07-25,0,0,0,0,0,0,0,0,0
2018-07-26,3581,1746,1835,836,547,83,52,146,171
2018-07-27,3136,1493,1643,684,507,137,42,128,145
2018-07-28,5786,2426,3360,1100,529,82,550,132,967
2018-07-29,4833,2848,1985,1087,499,98,75,115,111
2018-07-30,3113,1648,1465,557,513,89,60,114,132
2018-07-31,2832,1430,1402,586,513,82,43,97,81
2018-08-01,3306,1538,1768,576,832,75,35,113,137
2018-08-02,3241,1635,1606,649,618,103,40,109,87
2018-08-03,3738,1934,1804,775,647,71,57,152,102
2018-08-04,4887,2883,2004,1051,559,113,59,132,90
2018-08-05,6378,3715,2663,1571,630,117,79,177,89
2018-08-06,4968,2652,2316,1060,790,116,60,164,126
2018-08-07,5192,2680,2512,1163,809,94,87,229,130
2018-08-08,0,0,0,0,0,0,0,0,0
2018-08-09,3058,1658,1400,443,602,81,40,117,117
2018-08-10,6422,3668,2754,1389,880,126,73,183,103
2018-08-11,9215,5548,3667,1776,1161,192,151,226,161
2018-08-12,15432,9261,6171,3408,1659,304,238,346,216
2018-08-13,8138,4833,3305,1543,1022,232,128,245,135
2018-08-14,7395,4670,2725,1197,925,205,105,185,108
2018-08-15,3714,2532,1182,447,463,118,40,71,43
2018-08-16,1034,618,416,165,99,49,14,29,60
2018-08-17,4097,2231,1866,766,602,93,45,175,185
2018-08-18,8433,4768,3665,2067,780,132,183,331,172
2018-08-19,4585,2690,1895,970,454,142,68,161,100
2018-08-20,4360,2605,1755,877,334,108,64,217,155
2018-08-21,2916,1542,1374,767,219,74,37,138,139
2018-08-22,0,0,0,0,0,0,0,0,0
2018-08-23,3862,1944,1918,1239,173,175,63,117,151
2018-08-24,2657,1109,1548,682,541,60,23,63,179
2018-08-25,2124,1425,699,361,175,49,30,42,42
2018-08-26,6587,3908,2679,1638,503,89,115,163,171
2018-08-27,3537,1958,1579,751,448,32,42,133,173
2018-08-28,3927,1747,2180,746,971,53,35,168,207
2018-08-29,4083,1814,2269,1251,446,14,49,192,317
2018-08-30,1593,709,884,295,357,25,30,15,162
2018-08-31,2129,987,1142,274,667,33,22,40,106
